15 24
10 13
5
0
0 0
1	1	1	1	1	1	1	1	1	1	1	1	1	1	1
1	1	1	1	1	1	1	1	1	1	1	1	1	1	1
1	1	1	1	1	1	1	1	1	1	1	1	1	1	1
1	1	1	1	30	30	30	30	30	30	30	1	1	1	1
1	1	1	1	30	31	31	31	31	31	30	1	1	1	1
1	1	1	1	30	31	31	31	31	31	30	1	1	1	1
1	1	1	1	30	31	31	31	31	31	30	1	1	1	1
1	1	1	1	31	40	40	40	40	40	30	1	1	1	1
1	1	1	1	31	40	40	40	40	40	30	1	1	1	1
1	1	1	1	31	40	40	40	40	40	31	1	1	1	1
1	1	1	0	40	40	40	40	40	40	31	1	1	1	1
1	1	1	1	30	40	40	40	40	40	31	1	1	1	1
1	1	1	1	30	40	40	40	40	40	40	0	1	1	1
1	1	1	1	31	40	40	40	40	40	40	0	1	1	1
1	1	1	1	31	40	40	40	40	40	40	0	1	1	1
1	1	1	1	31	40	40	40	40	40	30	1	1	1	1
1	1	1	0	40	40	40	40	40	40	30	1	1	1	1
1	1	1	1	30	40	40	40	40	40	30	1	1	1	1
1	1	1	1	30	40	40	40	40	40	30	1	1	1	1
1	1	1	1	30	40	40	40	40	40	30	1	1	1	1
1	1	1	1	30	30	30	30	30	30	30	1	1	1	1
1	1	1	1	1	1	1	1	1	1	1	1	1	1	1
1	1	1	1	1	1	1	1	1	1	1	1	1	1	1
1	1	1	1	1	1	1	1	1	1	1	1	1	1	1
584 11 12
584 11 13
584 11 14
585 3 10
585 3 16
10