15 24
10 13
5
0
0 0
1	1	1	1	1	1	1	1	1	1	1	1	1	1	1
1	1	1	1	1	1	1	1	1	1	1	1	1	1	1
1	1	1	1	1	1	1	1	1	1	1	1	1	1	1
1	1	1	1	34	34	34	34	34	34	34	1	1	1	1
1	1	1	1	34	35	35	35	35	35	34	1	1	1	1
1	1	1	1	34	35	35	35	35	35	34	1	1	1	1
1	1	1	1	34	35	35	35	35	35	34	1	1	1	1
1	1	1	1	35	40	40	40	40	40	34	1	1	1	1
1	1	1	1	35	40	40	40	40	40	34	1	1	1	1
1	1	1	1	35	40	40	40	40	40	35	1	1	1	1
1	1	1	0	40	40	40	40	40	40	35	1	1	1	1
1	1	1	1	34	40	40	40	40	40	35	1	1	1	1
1	1	1	1	34	40	40	40	40	40	40	0	1	1	1
1	1	1	1	35	40	40	40	40	40	40	0	1	1	1
1	1	1	1	35	40	40	40	40	40	40	0	1	1	1
1	1	1	1	35	40	40	40	40	40	34	1	1	1	1
1	1	1	0	40	40	40	40	40	40	34	1	1	1	1
1	1	1	1	34	40	40	40	40	40	34	1	1	1	1
1	1	1	1	34	40	40	40	40	40	34	1	1	1	1
1	1	1	1	34	40	40	40	40	40	34	1	1	1	1
1	1	1	1	34	34	34	34	34	34	34	1	1	1	1
1	1	1	1	1	1	1	1	1	1	1	1	1	1	1
1	1	1	1	1	1	1	1	1	1	1	1	1	1	1
1	1	1	1	1	1	1	1	1	1	1	1	1	1	1
584 11 12
584 11 13
584 11 14
585 3 10
585 3 16
10