14 16
10 9
1
0
0 0
1	1	1	1	1	1	1	1	1	1	1	1	1	1
1	1	1	1	1	1	1	1	1	1	1	1	1	1
1	1	1	1	1	1	1	1	1	1	1	1	1	1
1	1	1	1	34	34	34	34	34	34	34	1	1	1
1	1	1	1	34	35	35	35	35	35	34	1	1	1
1	1	1	1	34	35	35	35	35	35	34	1	1	1
1	1	1	1	34	35	35	35	35	35	35	1	1	1
1	1	1	1	34	40	40	40	40	40	35	1	1	1
1	1	1	1	34	40	40	40	40	40	35	1	1	1
1	1	1	1	34	40	40	40	40	40	40	0	1	1
1	1	1	1	34	40	40	40	40	40	34	1	1	1
1	1	1	1	34	40	40	40	40	40	34	1	1	1
1	1	1	1	34	34	34	34	34	34	34	1	1	1
1	1	1	1	1	1	1	1	1	1	1	1	1	1
1	1	1	1	1	1	1	1	1	1	1	1	1	1
1	1	1	1	1	1	1	1	1	1	1	1	1	1
610 11 9
33