13 17
6 7
1
0
0 0
1	1	1	1	1	1	1	1	1	1	1	1	1
1	1	1	1	1	1	1	1	1	1	1	1	1
1	1	1	1	1	1	1	1	1	1	1	1	1
1	1	1	34	34	34	34	34	34	34	1	1	1
1	1	1	34	35	35	35	35	35	34	1	1	1
1	1	1	34	35	35	35	35	35	34	1	1	1
1	1	1	34	35	35	35	35	35	34	1	1	1
1	1	1	34	40	40	40	40	40	34	1	1	1
1	1	1	34	40	40	40	40	40	34	1	1	1
1	1	1	34	40	40	40	40	40	34	1	1	1
1	1	1	34	40	40	40	40	40	34	1	1	1
1	1	1	34	40	40	40	40	40	34	1	1	1
1	1	1	34	34	34	40	34	34	34	1	1	1
1	1	1	1	1	1	0	1	1	1	1	1	1
1	1	1	1	1	1	1	1	1	1	1	1	1
1	1	1	1	1	1	1	1	1	1	1	1	1
1	1	1	1	1	1	1	1	1	1	1	1	1
595 6 13
18