35 34
6 29
6
0
0 0
1	1	1	1	1	1	1	1	1	1	1	1	1	1	1	1	1	1	1	1	1	1	1	1	1	1	1	1	1	1	1	1	1	1	1
1	1	1	1	1	1	1	1	1	1	1	1	1	1	1	1	1	1	1	1	1	1	1	1	1	1	1	1	1	1	1	1	1	1	1
1	1	1	1	1	1	1	1	1	1	1	1	1	1	1	1	1	1	1	1	1	1	1	1	1	1	1	1	1	1	1	1	1	1	1
1	1	1	1	1	1	1	1	1	40	40	40	40	40	1	1	1	35	35	35	1	1	1	1	1	1	1	1	1	1	1	1	1	1	1
1	1	1	1	1	1	1	1	1	40	40	40	40	40	1	1	1	35	35	35	1	1	1	1	1	1	1	1	1	1	1	1	1	1	1
1	1	1	1	1	1	1	1	1	40	40	40	40	40	21	1	1	35	0	35	1	1	1	1	1	1	1	1	1	1	1	1	1	1	1
1	1	1	1	1	1	1	1	1	40	40	40	40	40	1	21	1	40	40	40	1	1	1	1	1	1	1	1	1	1	1	1	1	1	1
1	1	1	1	1	1	1	1	1	40	40	40	40	40	1	1	21	40	40	40	21	1	1	40	40	40	40	40	1	1	20	0	1	1	1
1	1	1	1	1	1	1	1	1	1	1	19	1	1	1	1	1	40	40	40	1	21	1	40	40	40	40	40	1	20	1	1	1	1	1
1	1	1	1	1	1	1	1	1	1	1	19	1	1	1	1	1	1	1	1	1	1	21	40	40	40	40	40	20	1	1	1	1	1	1
1	1	1	1	1	1	1	1	1	1	1	19	1	1	1	1	1	1	1	1	1	1	1	40	40	40	40	40	1	1	1	1	1	1	1
1	1	1	35	35	35	35	35	35	35	40	40	40	1	1	1	1	1	1	1	1	1	1	40	40	40	40	40	1	1	1	1	1	1	1
1	1	1	35	35	35	35	35	35	35	40	40	40	1	1	1	1	1	1	1	1	1	1	1	1	18	1	1	1	1	1	1	1	1	1
1	1	1	35	35	35	0	35	35	35	40	40	40	1	1	1	1	1	1	1	1	1	1	1	1	18	1	1	1	1	1	1	1	1	1
1	1	1	40	40	40	40	40	40	40	40	40	40	1	1	1	1	1	1	1	1	1	1	1	1	18	1	1	1	1	1	1	1	1	1
1	1	1	40	40	40	40	40	40	40	40	40	40	1	1	1	1	1	1	1	1	1	1	1	40	40	40	1	1	1	1	1	1	1	1
1	1	1	40	40	40	40	40	40	40	40	40	40	1	1	1	1	1	1	1	1	1	1	1	40	40	40	1	1	1	1	1	1	1	1
1	1	1	40	40	40	40	40	40	40	40	40	40	1	1	1	1	1	1	1	1	1	1	1	40	40	40	1	1	1	1	1	1	1	1
1	1	1	40	40	40	40	40	40	40	40	40	40	1	1	1	1	1	1	1	1	1	1	1	1	18	1	1	1	1	1	1	1	1	1
1	1	1	1	1	1	1	1	1	1	40	40	40	1	1	1	1	1	1	1	1	1	1	1	1	18	1	1	1	1	1	1	1	1	1
1	1	1	1	1	1	1	1	1	1	40	40	40	1	1	1	1	1	1	1	1	1	1	1	1	18	1	1	1	1	1	1	1	1	1
1	1	1	1	1	1	1	1	1	1	40	40	40	1	1	1	1	35	35	35	1	1	1	40	40	40	40	40	1	1	20	0	1	1	1
1	1	1	1	1	1	1	1	1	1	1	19	1	1	1	1	1	35	35	35	1	1	1	40	40	40	40	40	1	20	1	1	1	1	1
1	1	1	1	1	1	1	1	1	1	1	19	1	1	1	1	1	35	0	35	1	1	20	40	40	40	40	40	20	1	1	1	1	1	1
1	1	1	1	1	1	1	1	1	1	1	19	1	1	1	1	1	40	40	40	1	20	1	40	40	40	40	40	1	1	1	1	1	1	1
1	1	1	1	1	1	1	1	1	40	40	40	40	40	1	1	20	40	40	40	20	1	1	40	40	40	40	40	1	1	1	1	1	1	1
1	1	1	1	1	1	1	1	1	40	40	40	40	40	1	20	1	40	40	40	1	1	1	1	1	1	1	1	1	1	1	1	1	1	1
1	1	1	1	1	1	1	1	20	40	40	40	40	40	20	1	1	1	1	1	1	1	1	1	1	1	1	1	1	1	1	1	1	1	1
1	1	1	1	1	1	1	20	1	40	40	40	40	40	1	1	1	1	1	1	1	1	1	1	1	1	1	1	1	1	1	1	1	1	1
1	1	1	1	1	0	20	1	1	40	40	40	40	40	1	1	1	1	1	1	1	1	1	1	1	1	1	1	1	1	1	1	1	1	1
1	1	1	1	1	0	1	1	1	1	1	1	1	1	1	1	1	1	1	1	1	1	1	1	1	1	1	1	1	1	1	1	1	1	1
1	1	1	1	1	1	1	1	1	1	1	1	1	1	1	1	1	1	1	1	1	1	1	1	1	1	1	1	1	1	1	1	1	1	1
1	1	1	1	1	1	1	1	1	1	1	1	1	1	1	1	1	1	1	1	1	1	1	1	1	1	1	1	1	1	1	1	1	1	1
1	1	1	1	1	1	1	1	1	1	1	1	1	1	1	1	1	1	1	1	1	1	1	1	1	1	1	1	1	1	1	1	1	1	1
618 5 29
619 6 13
620 18 23
621 18 5
622 31 21
623 31 7
35