35 34
6 29
6
63
0 0
1	1	1	1	1	1	1	1	1	1	1	1	1	1	1	1	1	1	1	1	1	1	1	1	1	1	1	1	1	1	1	1	1	1	1
1	1	1	1	1	1	1	1	1	1	1	1	1	1	1	1	1	1	1	1	1	1	1	1	1	1	1	1	1	1	1	1	1	1	1
1	1	1	1	1	1	1	1	1	1	1	1	1	1	1	1	1	1	1	1	1	1	1	1	1	1	1	1	1	1	1	1	1	1	1
1	1	1	1	1	1	1	1	1	40	40	40	40	40	1	1	1	35	35	35	1	1	1	1	1	1	1	1	1	1	1	1	1	1	1
1	1	1	1	1	1	1	1	1	40	40	40	40	40	1	1	1	35	35	35	1	1	1	1	1	1	1	1	1	1	1	1	1	1	1
1	1	1	1	1	1	1	1	1	40	40	40	40	40	21	1	1	35	0	35	1	1	1	1	1	1	1	1	1	1	1	1	1	1	1
1	1	1	1	1	1	1	1	1	40	40	40	40	40	1	21	1	40	40	40	1	1	1	1	1	1	1	1	1	1	1	1	1	1	1
1	1	1	1	1	1	1	1	1	40	40	40	40	40	1	1	21	40	40	40	21	1	1	40	40	40	40	40	1	1	20	0	1	1	1
1	1	1	1	1	1	1	1	1	1	1	19	1	1	1	1	1	40	40	40	1	21	1	40	40	40	40	40	1	20	1	1	1	1	1
1	1	1	1	1	1	1	1	1	1	1	19	1	1	1	1	1	1	1	1	1	1	21	40	40	40	40	40	20	1	1	1	1	1	1
1	1	1	1	1	1	1	1	1	1	1	19	1	1	1	1	1	1	1	1	1	1	1	40	40	40	40	40	1	1	1	1	1	1	1
1	1	1	35	35	35	35	35	35	35	40	40	40	1	1	1	1	1	1	1	1	1	1	40	40	40	40	40	1	1	1	1	1	1	1
1	1	1	35	35	35	35	35	35	35	40	40	40	1	1	1	1	1	1	1	1	1	1	1	1	18	1	1	1	1	1	1	1	1	1
1	1	1	35	35	35	0	35	35	35	40	40	40	1	1	1	1	1	1	1	1	1	1	1	1	18	1	1	1	1	1	1	1	1	1
1	1	1	40	40	40	40	40	40	40	40	40	40	1	1	1	1	1	1	1	1	1	1	1	1	18	1	1	1	1	1	1	1	1	1
1	1	1	40	40	40	40	40	40	40	40	40	40	1	1	1	1	1	1	1	1	1	1	1	40	40	40	1	1	1	1	1	1	1	1
1	1	1	40	40	40	40	40	40	40	40	40	40	1	1	1	1	1	1	1	1	1	1	1	40	40	40	1	1	1	1	1	1	1	1
1	1	1	40	40	40	40	40	40	40	40	40	40	1	1	1	1	1	1	1	1	1	1	1	40	40	40	1	1	1	1	1	1	1	1
1	1	1	40	40	40	40	40	40	40	40	40	40	1	1	1	1	1	1	1	1	1	1	1	1	18	1	1	1	1	1	1	1	1	1
1	1	1	1	1	1	1	1	1	1	40	40	40	1	1	1	1	1	1	1	1	1	1	1	1	18	1	1	1	1	1	1	1	1	1
1	1	1	1	1	1	1	1	1	1	40	40	40	1	1	1	1	1	1	1	1	1	1	1	1	18	1	1	1	1	1	1	1	1	1
1	1	1	1	1	1	1	1	1	1	40	40	40	1	1	1	1	35	35	35	1	1	1	40	40	40	40	40	1	1	20	0	1	1	1
1	1	1	1	1	1	1	1	1	1	1	19	1	1	1	1	1	35	35	35	1	1	1	40	40	40	40	40	1	20	1	1	1	1	1
1	1	1	1	1	1	1	1	1	1	1	19	1	1	1	1	1	35	0	35	1	1	20	40	40	40	40	40	20	1	1	1	1	1	1
1	1	1	1	1	1	1	1	1	1	1	19	1	1	1	1	1	40	40	40	1	20	1	40	40	40	40	40	1	1	1	1	1	1	1
1	1	1	1	1	1	1	1	1	40	40	40	40	40	1	1	20	40	40	40	20	1	1	40	40	40	40	40	1	1	1	1	1	1	1
1	1	1	1	1	1	1	1	1	40	40	40	40	40	1	20	1	40	40	40	1	1	1	1	1	1	1	1	1	1	1	1	1	1	1
1	1	1	1	1	1	1	1	20	40	40	40	40	40	20	1	1	1	1	1	1	1	1	1	1	1	1	1	1	1	1	1	1	1	1
1	1	1	1	1	1	1	20	1	40	40	40	40	40	1	1	1	1	1	1	1	1	1	1	1	1	1	1	1	1	1	1	1	1	1
1	1	1	1	1	0	20	1	1	40	40	40	40	40	1	1	1	1	1	1	1	1	1	1	1	1	1	1	1	1	1	1	1	1	1
1	1	1	1	1	0	1	1	1	1	1	1	1	1	1	1	1	1	1	1	1	1	1	1	1	1	1	1	1	1	1	1	1	1	1
1	1	1	1	1	1	1	1	1	1	1	1	1	1	1	1	1	1	1	1	1	1	1	1	1	1	1	1	1	1	1	1	1	1	1
1	1	1	1	1	1	1	1	1	1	1	1	1	1	1	1	1	1	1	1	1	1	1	1	1	1	1	1	1	1	1	1	1	1	1
1	1	1	1	1	1	1	1	1	1	1	1	1	1	1	1	1	1	1	1	1	1	1	1	1	1	1	1	1	1	1	1	1	1	1
618 5 29
619 6 13
620 18 23
621 18 5
622 31 21
623 31 7
32 192 896
32 224 864
32 256 832
33 192 928
33 224 896
33 256 864
93 192 960
93 224 928
93 256 896
32 448 832
32 480 800
32 512 768
33 448 864
33 480 832
33 512 800
93 448 896
93 480 864
93 512 832
32 640 768 
32 672 736 
32 704 704
33 640 800 
33 672 768 
33 704 736
93 640 832 
93 672 800 
93 704 768
36 640 192
36 672 224
36 704 256
37 640 224
37 672 256
37 704 288
95 640 256
95 672 288
95 704 320
36 448 128
36 480 160
36 512 192
37 448 160
37 480 192
37 512 224
95 448 192
95 480 224
95 512 256
32 896 256
32 928 224
32 960 192
33 896 288
33 928 256
33 960 224
93 896 320
93 928 288
93 960 256
32 896 704
32 928 672
32 960 640
33 896 736
33 928 704
33 960 672
93 896 768
93 928 736
93 960 704
35