13 16
6 7
1
0
0 0
1	1	1	1	1	1	1	1	1	1	1	1	1
1	1	1	1	1	1	1	1	1	1	1	1	1
1	1	1	1	1	1	1	1	1	1	1	1	1
1	1	1	30	30	30	30	30	30	30	1	1	1
1	1	1	30	31	31	31	31	31	30	1	1	1
1	1	1	30	31	31	31	31	31	30	1	1	1
1	1	1	30	31	31	31	31	31	30	1	1	1
1	1	1	30	40	40	40	40	40	30	1	1	1
1	1	1	30	40	40	40	40	40	30	1	1	1
1	1	1	30	40	40	40	40	40	30	1	1	1
1	1	1	30	40	40	40	40	40	30	1	1	1
1	1	1	30	40	40	40	40	40	30	1	1	1
1	1	1	30	30	30	30	30	30	30	1	1	1
1	1	1	1	1	1	1	1	1	1	1	1	1
1	1	1	1	1	1	1	1	1	1	1	1	1
1	1	1	1	1	1	1	1	1	1	1	1	1
600 6 6
18