28 37
23 21
4
9
0 0
1	1	1	1	1	1	1	1	1	1	1	1	1	1	1	1	1	1	1	1	1	1	1	1	1	1	1	1
1	1	1	1	1	1	1	1	1	1	1	1	1	1	1	1	1	1	1	1	1	1	1	1	1	1	1	1
1	1	1	1	1	1	1	1	1	1	1	1	1	1	1	1	1	1	1	1	1	1	1	1	1	1	1	1
1	1	1	1	34	34	34	34	34	34	34	34	34	34	34	1	1	1	1	1	1	1	1	1	1	1	1	1
1	1	1	1	34	35	35	35	35	35	35	35	35	35	34	1	1	1	1	1	1	1	1	1	1	1	1	1
1	1	1	1	34	35	35	35	35	35	35	35	35	35	34	1	1	1	1	1	1	1	1	1	1	1	1	1
1	1	1	1	35	35	35	35	35	35	35	35	35	35	35	1	1	1	1	1	1	1	1	1	1	1	1	1
1	1	1	1	35	40	40	40	40	40	40	40	40	40	35	1	1	1	1	1	1	1	1	1	1	1	1	1
1	1	1	1	35	40	40	40	40	40	40	40	40	40	35	1	1	1	1	1	1	1	1	1	1	1	1	1
1	1	1	0	40	40	40	40	40	40	40	40	40	40	40	0	1	1	1	1	1	1	1	1	1	1	1	1
1	1	1	1	34	40	40	40	40	40	40	40	40	40	34	1	1	1	1	1	1	1	1	1	1	1	1	1
1	1	1	1	34	40	40	40	40	40	40	40	40	40	34	1	1	1	1	1	1	1	1	1	1	1	1	1
1	1	1	1	34	40	40	40	40	40	40	40	40	40	34	1	1	1	1	1	1	1	1	1	1	1	1	1
1	1	1	1	34	40	40	40	40	40	40	40	40	40	34	1	1	1	1	1	1	1	1	1	1	1	1	1
1	1	1	1	34	40	40	40	40	40	40	40	40	40	34	1	1	1	1	1	1	1	1	1	1	1	1	1
1	1	1	1	34	40	40	40	40	40	34	34	34	34	34	34	34	34	34	34	34	1	1	1	1	1	1	1
1	1	1	1	34	40	40	40	40	40	35	35	35	35	35	35	35	35	35	35	34	1	1	1	1	1	1	1
1	1	1	1	34	40	40	40	40	40	35	35	35	35	35	35	35	35	35	35	34	1	1	1	1	1	1	1
1	1	1	1	34	40	40	40	40	40	35	35	35	35	35	35	35	35	35	35	34	1	1	1	1	1	1	1
1	1	1	1	34	40	40	40	40	40	40	40	40	40	40	40	40	40	40	40	34	1	1	1	1	1	1	1
1	1	1	1	34	40	40	40	40	40	40	40	40	40	40	40	40	40	40	40	35	1	1	1	1	1	1	1
1	1	1	1	34	40	40	40	40	40	40	40	40	40	40	40	40	40	40	40	35	1	1	20	0	1	1	1
1	1	1	1	34	40	40	40	40	40	40	40	40	40	40	40	40	40	40	40	35	1	20	1	1	1	1	1
1	1	1	1	34	40	40	40	40	40	40	40	40	40	40	40	40	40	40	40	40	20	1	1	1	1	1	1
1	1	1	1	34	40	40	40	40	40	40	40	40	40	40	40	40	40	40	40	40	1	1	1	1	1	1	1
1	1	1	1	34	40	40	40	40	40	40	40	40	40	40	40	40	40	40	40	34	1	1	1	1	1	1	1
1	1	1	1	34	40	40	40	40	40	40	40	40	40	40	40	40	40	40	40	34	1	1	1	1	1	1	1
1	1	1	1	34	40	40	40	40	40	40	40	40	40	40	40	40	40	40	40	34	1	1	1	1	1	1	1
1	1	1	1	34	40	40	40	40	40	40	40	40	40	34	34	34	34	34	34	34	1	1	1	1	1	1	1
1	1	1	1	34	40	40	40	40	40	40	40	40	40	34	1	1	1	1	1	1	1	1	1	1	1	1	1
1	1	1	1	34	40	40	40	40	40	40	40	40	40	34	1	1	1	1	1	1	1	1	1	1	1	1	1
1	1	1	1	34	40	40	40	40	40	40	40	40	40	34	1	1	1	1	1	1	1	1	1	1	1	1	1
1	1	1	1	34	34	34	34	34	40	34	34	34	34	34	1	1	1	1	1	1	1	1	1	1	1	1	1
1	1	1	1	1	1	1	1	1	0	1	1	1	1	1	1	1	1	1	1	1	1	1	1	1	1	1	1
1	1	1	1	1	1	1	1	1	1	1	1	1	1	1	1	1	1	1	1	1	1	1	1	1	1	1	1
1	1	1	1	1	1	1	1	1	1	1	1	1	1	1	1	1	1	1	1	1	1	1	1	1	1	1	1
1	1	1	1	1	1	1	1	1	1	1	1	1	1	1	1	1	1	1	1	1	1	1	1	1	1	1	1
605 24 21
606 15 9
607 3 9
608 9 33
32 672 704
32 704 672
32 736 640
33 672 736
33 704 704
33 736 672
93 672 768
93 704 736
93 736 704
32