36 32
23 22
3
27
0 0
1	1	1	1	1	1	1	1	1	1	1	1	1	1	1	1	1	1	1	1	1	1	1	1	1	1	1	1	1	1	1	1	1	1	1	1
1	1	1	1	1	1	1	1	1	1	1	1	1	1	1	1	1	1	1	1	1	1	1	1	1	1	1	1	1	1	1	1	1	1	1	1
1	1	1	1	1	1	1	1	1	1	1	1	1	1	1	1	1	1	1	1	1	1	1	1	1	1	1	1	1	1	1	1	1	1	1	1
1	1	1	1	1	1	1	1	1	1	1	1	1	1	1	1	1	34	34	34	34	34	34	34	34	1	34	34	34	34	34	34	34	1	1	1
1	1	1	1	1	1	1	1	1	1	1	1	1	1	1	1	1	34	35	35	35	35	35	35	34	1	34	35	35	35	35	35	34	1	1	1
1	1	1	1	1	1	1	1	1	1	1	1	1	1	1	1	1	34	35	35	35	35	35	35	34	34	34	35	35	35	35	35	34	1	1	1
1	1	1	1	1	1	1	1	1	1	1	1	1	1	1	1	1	34	35	35	35	35	35	35	35	35	35	35	35	35	35	35	34	1	1	1
1	1	1	1	1	1	1	1	1	1	1	1	1	1	1	1	1	34	40	40	40	40	40	40	35	35	35	40	40	40	40	40	34	1	1	1
1	1	1	1	1	1	1	1	1	1	1	1	1	1	1	1	1	34	40	40	40	40	40	40	35	35	35	40	40	40	40	40	34	1	1	1
1	1	1	1	1	1	1	1	1	34	34	34	34	34	34	34	34	34	40	40	40	40	40	40	40	40	40	40	40	40	40	40	34	1	1	1
1	1	1	1	1	1	1	1	1	34	35	35	35	35	35	35	35	35	40	40	40	40	40	40	40	40	40	40	40	40	40	40	34	1	1	1
1	1	1	1	1	1	1	1	1	34	35	35	35	35	35	35	35	35	40	40	40	40	40	40	40	40	40	40	40	40	40	40	34	1	1	1
1	1	1	1	1	1	1	1	1	34	35	35	35	0	35	35	35	35	40	40	40	40	40	40	40	40	40	40	40	40	40	40	34	1	1	1
1	1	1	1	1	1	1	1	1	34	40	40	40	40	40	40	40	40	40	40	40	40	40	40	40	40	40	40	40	40	40	40	34	1	1	1
1	1	1	1	1	1	1	1	1	34	40	40	40	40	40	40	40	40	40	40	40	40	40	40	40	40	34	40	40	40	40	40	34	1	1	1
1	1	1	1	1	1	1	1	1	34	40	40	40	40	40	40	40	34	34	34	34	34	34	34	34	34	34	40	40	40	40	40	34	1	1	1
1	1	1	1	1	1	1	1	1	34	40	40	40	40	40	40	40	34	1	1	1	1	1	1	1	1	35	40	40	40	40	40	34	1	1	1
1	1	1	1	1	1	1	1	1	34	40	40	40	40	40	40	40	34	1	1	1	1	1	1	1	1	35	40	40	40	40	40	34	1	1	1
1	1	1	1	1	1	1	34	34	34	40	40	40	40	34	34	34	34	1	1	1	1	1	1	1	1	35	40	40	40	40	40	34	1	1	1
1	1	1	1	1	1	1	34	35	35	40	40	40	40	34	1	1	1	1	1	1	1	1	1	1	1	40	40	40	40	40	40	34	1	1	1
1	1	1	1	1	1	1	34	35	35	40	40	40	40	34	1	1	1	1	1	1	1	1	1	1	20	40	40	40	40	40	40	34	1	1	1
1	1	1	1	1	1	1	34	35	35	40	40	40	40	34	1	1	1	1	1	1	1	1	1	20	1	34	40	40	40	40	40	34	1	1	1
1	1	1	1	1	1	1	34	40	40	40	40	40	40	34	1	1	1	1	1	1	1	0	20	1	1	34	40	40	40	40	40	34	1	1	1
1	1	1	1	1	1	1	35	40	40	40	40	40	40	35	1	1	1	1	1	1	1	0	1	1	1	34	40	40	40	40	40	34	1	1	1
1	1	1	1	1	1	1	35	40	40	40	40	40	40	35	1	1	20	0	1	1	1	1	1	1	1	34	34	34	34	34	34	34	1	1	1
1	1	1	1	1	1	1	35	40	40	40	40	40	40	35	1	20	1	1	1	1	1	1	1	1	1	1	1	1	1	1	1	1	1	1	1
1	1	1	1	1	1	1	40	40	40	40	40	40	40	40	20	1	1	1	1	1	1	1	1	1	1	1	1	1	1	1	1	1	1	1	1
1	1	1	1	1	1	20	40	40	40	40	40	40	40	40	1	1	1	1	1	1	1	1	1	1	1	1	1	1	1	1	1	1	1	1	1
1	1	1	1	1	20	1	34	34	34	34	34	34	34	34	1	1	1	1	1	1	1	1	1	1	1	1	1	1	1	1	1	1	1	1	1
1	1	1	0	20	1	1	1	1	1	1	1	1	1	1	1	1	1	1	1	1	1	1	1	1	1	1	1	1	1	1	1	1	1	1	1
1	1	1	1	1	1	1	1	1	1	1	1	1	1	1	1	1	1	1	1	1	1	1	1	1	1	1	1	1	1	1	1	1	1	1	1
1	1	1	1	1	1	1	1	1	1	1	1	1	1	1	1	1	1	1	1	1	1	1	1	1	1	1	1	1	1	1	1	1	1	1	1
601 22 22
602 3 29
603 18 24
32 128 896
32 160 864
32 192 832
33 128 928
33 160 896
33 192 864
93 128 960
93 160 928
93 192 896
32 480 800
32 512 768
32 544 736
33 480 832
33 512 800
33 544 768
93 480 864
93 512 832
93 544 800
32 736 672
32 768 640
32 800 608
33 736 704
33 768 672
33 800 640
93 736 736
93 768 704
93 800 672
30