36 32
23 22
3
0
0 0
1	1	1	1	1	1	1	1	1	1	1	1	1	1	1	1	1	1	1	1	1	1	1	1	1	1	1	1	1	1	1	1	1	1	1	1
1	1	1	1	1	1	1	1	1	1	1	1	1	1	1	1	1	1	1	1	1	1	1	1	1	1	1	1	1	1	1	1	1	1	1	1
1	1	1	1	1	1	1	1	1	1	1	1	1	1	1	1	1	1	1	1	1	1	1	1	1	1	1	1	1	1	1	1	1	1	1	1
1	1	1	1	1	1	1	1	1	1	1	1	1	1	1	1	1	34	34	34	34	34	34	34	34	1	34	34	34	34	34	34	34	1	1	1
1	1	1	1	1	1	1	1	1	1	1	1	1	1	1	1	1	34	35	35	35	35	35	35	34	1	34	35	35	35	35	35	34	1	1	1
1	1	1	1	1	1	1	1	1	1	1	1	1	1	1	1	1	34	35	35	35	35	35	35	34	34	34	35	35	35	35	35	34	1	1	1
1	1	1	1	1	1	1	1	1	1	1	1	1	1	1	1	1	34	35	35	35	35	35	35	35	35	35	35	35	35	35	35	34	1	1	1
1	1	1	1	1	1	1	1	1	1	1	1	1	1	1	1	1	34	40	40	40	40	40	40	35	35	35	40	40	40	40	40	34	1	1	1
1	1	1	1	1	1	1	1	1	1	1	1	1	1	1	1	1	34	40	40	40	40	40	40	35	35	35	40	40	40	40	40	34	1	1	1
1	1	1	1	1	1	1	1	1	34	34	34	34	34	34	34	34	34	40	40	40	40	40	40	40	40	40	40	40	40	40	40	34	1	1	1
1	1	1	1	1	1	1	1	1	34	35	35	35	35	35	35	35	35	40	40	40	40	40	40	40	40	40	40	40	40	40	40	34	1	1	1
1	1	1	1	1	1	1	1	1	34	35	35	35	35	35	35	35	35	40	40	40	40	40	40	40	40	40	40	40	40	40	40	34	1	1	1
1	1	1	1	1	1	1	1	1	34	35	35	35	0	35	35	35	35	40	40	40	40	40	40	40	40	40	40	40	40	40	40	34	1	1	1
1	1	1	1	1	1	1	1	1	34	40	40	40	40	40	40	40	40	40	40	40	40	40	40	40	40	40	40	40	40	40	40	34	1	1	1
1	1	1	1	1	1	1	1	1	34	40	40	40	40	40	40	40	40	40	40	40	40	40	40	40	40	34	40	40	40	40	40	34	1	1	1
1	1	1	1	1	1	1	1	1	34	40	40	40	40	40	40	40	34	34	34	34	34	34	34	34	34	34	40	40	40	40	40	34	1	1	1
1	1	1	1	1	1	1	1	1	34	40	40	40	40	40	40	40	34	1	1	1	1	1	1	1	1	34	40	40	40	40	40	34	1	1	1
1	1	1	1	1	1	1	1	1	34	40	40	40	40	40	40	40	34	1	1	1	1	1	1	1	1	35	40	40	40	40	40	34	1	1	1
1	1	1	1	1	1	1	34	34	34	40	40	40	40	40	40	40	34	1	1	1	1	1	1	1	1	35	40	40	40	40	40	34	1	1	1
1	1	1	1	1	1	1	34	35	35	40	40	40	40	40	40	40	34	1	1	1	1	1	1	1	1	35	40	40	40	40	40	34	1	1	1
1	1	1	1	1	1	1	34	35	35	40	40	40	40	40	40	40	34	1	1	1	1	1	1	1	20	40	40	40	40	40	40	34	1	1	1
1	1	1	1	1	1	1	34	35	35	40	40	40	40	40	40	40	34	1	1	1	1	1	1	20	1	34	40	40	40	40	40	34	1	1	1
1	1	1	1	1	1	1	34	40	40	40	40	40	40	40	40	40	34	1	1	1	1	0	20	1	1	34	40	40	40	40	40	34	1	1	1
1	1	1	1	1	1	1	34	40	40	40	40	40	40	34	34	34	34	1	1	1	1	0	1	1	1	34	40	40	40	40	40	34	1	1	1
1	1	1	1	1	1	1	35	40	40	40	40	40	40	35	1	1	1	1	1	1	1	1	1	1	1	34	34	34	34	34	34	34	1	1	1
1	1	1	1	1	1	1	35	40	40	40	40	40	40	35	1	1	20	0	1	1	1	1	1	1	1	1	1	1	1	1	1	1	1	1	1
1	1	1	1	1	1	1	35	40	40	40	40	40	40	35	1	20	1	1	1	1	1	1	1	1	1	1	1	1	1	1	1	1	1	1	1
1	1	1	1	1	1	20	40	40	40	40	40	40	40	40	20	1	1	1	1	1	1	1	1	1	1	1	1	1	1	1	1	1	1	1	1
1	1	1	1	1	20	1	34	34	34	34	34	34	34	34	1	1	1	1	1	1	1	1	1	1	1	1	1	1	1	1	1	1	1	1	1
1	1	1	0	20	1	1	1	1	1	1	1	1	1	1	1	1	1	1	1	1	1	1	1	1	1	1	1	1	1	1	1	1	1	1	1
1	1	1	1	1	1	1	1	1	1	1	1	1	1	1	1	1	1	1	1	1	1	1	1	1	1	1	1	1	1	1	1	1	1	1	1
1	1	1	1	1	1	1	1	1	1	1	1	1	1	1	1	1	1	1	1	1	1	1	1	1	1	1	1	1	1	1	1	1	1	1	1
601 22 22
602 3 29
603 18 25
30