25 32
20 15
9
9
0 0
1	1	1	1	1	1	1	1	1	1	1	1	1	1	1	1	1	1	1	1	1	1	1	1	1
1	1	1	1	1	1	1	1	1	1	1	1	1	1	1	1	1	1	1	1	1	1	1	1	1
1	1	1	1	1	1	1	1	1	1	1	1	1	1	1	1	1	1	1	1	1	1	1	1	1
1	1	1	1	1	1	1	1	1	1	1	1	1	1	34	34	34	34	34	34	34	1	1	1	1
1	1	1	1	1	1	1	1	1	1	1	1	1	1	34	35	35	35	35	35	34	1	1	1	1
1	1	1	1	1	1	1	1	1	1	1	1	1	1	34	35	35	35	35	35	34	1	1	1	1
1	1	1	1	1	1	1	1	1	1	1	1	1	1	34	35	35	35	35	35	34	1	1	1	1
1	1	1	1	1	1	1	1	1	1	1	1	1	1	34	40	40	40	40	40	34	1	1	1	1
1	1	1	1	1	1	1	1	1	1	1	1	1	1	34	40	40	40	40	40	34	1	1	1	1
1	1	1	1	1	1	1	1	1	1	1	1	1	1	34	40	40	40	40	40	34	1	1	1	1
1	1	1	1	1	1	1	1	1	1	1	1	1	1	34	40	40	40	40	40	34	1	1	1	1
1	1	1	34	34	34	34	34	34	34	34	34	34	34	34	40	40	40	40	40	34	1	1	1	1
1	1	1	34	35	35	35	35	35	35	35	35	35	35	35	40	40	40	40	40	35	1	1	1	1
1	1	1	34	35	35	35	35	35	35	35	35	35	35	35	40	40	40	40	40	35	1	1	1	1
1	1	1	34	35	35	35	35	35	35	35	35	35	35	35	40	40	40	40	40	35	1	1	1	1
1	1	1	34	40	40	40	40	40	40	40	40	40	40	40	40	40	40	40	40	40	0	1	1	1
1	1	1	34	40	40	40	40	40	40	40	40	40	40	40	40	40	40	40	40	34	1	1	1	1
1	1	1	34	40	40	40	40	40	40	40	40	40	40	40	40	40	40	40	40	34	1	1	1	1
1	1	1	34	40	40	40	40	40	40	40	40	40	40	40	40	40	40	40	40	35	1	1	1	1
1	1	1	34	40	40	40	40	40	40	40	40	40	40	40	40	40	40	40	40	35	1	1	1	1
1	1	1	34	40	40	40	40	40	40	40	40	40	40	40	40	40	40	40	40	35	1	1	1	1
1	1	1	34	40	40	40	40	40	40	40	40	40	40	40	40	40	40	40	40	40	0	1	1	1
1	1	1	34	34	40	34	34	40	34	34	40	34	34	34	40	40	40	40	34	34	1	1	1	1
1	1	1	1	1	0	1	1	0	1	1	0	1	1	34	40	40	40	40	35	35	1	1	0	1
1	1	1	1	1	1	1	1	1	1	1	1	1	1	34	40	40	40	40	35	35	1	20	0	1
1	1	1	1	1	1	1	1	1	1	1	1	1	1	34	40	40	40	40	35	35	20	1	1	1
1	1	1	1	1	1	1	1	1	1	1	1	1	1	34	40	40	40	40	40	20	1	1	1	1
1	1	1	1	1	1	1	1	1	1	1	1	1	1	34	40	40	40	40	40	1	1	1	1	1
1	1	1	1	1	1	1	1	1	1	1	1	1	1	34	34	34	34	34	34	1	1	1	1	1
1	1	1	1	1	1	1	1	1	1	1	1	1	1	1	1	1	1	1	1	1	1	1	1	1
1	1	1	1	1	1	1	1	1	1	1	1	1	1	1	1	1	1	1	1	1	1	1	1	1
1	1	1	1	1	1	1	1	1	1	1	1	1	1	1	1	1	1	1	1	1	1	1	1	1
586 21 15
586 21 21
587 11 14
588 8 14
589 5 14
590 11 23
591 5 23
592 8 23
593 23 24
32 640 800
32 672 768
32 704 736
33 640 832
33 672 800
33 704 768
93 640 864
93 672 832
93 704 800
19