13 16
6 7
1
0
0 0
1	1	1	1	1	1	1	1	1	1	1	1	1
1	1	1	1	1	1	1	1	1	1	1	1	1
1	1	1	1	1	1	1	1	1	1	1	1	1
1	1	1	34	34	34	34	34	34	34	1	1	1
1	1	1	34	35	35	35	35	35	34	1	1	1
1	1	1	34	35	35	35	35	35	34	1	1	1
1	1	1	34	35	35	35	35	35	34	1	1	1
1	1	1	34	40	40	40	40	40	34	1	1	1
1	1	1	34	40	40	40	40	40	34	1	1	1
1	1	1	34	40	40	40	40	40	34	1	1	1
1	1	1	34	40	40	40	40	40	34	1	1	1
1	1	1	34	40	40	40	40	40	34	1	1	1
1	1	1	34	34	34	34	34	34	34	1	1	1
1	1	1	1	1	1	1	1	1	1	1	1	1
1	1	1	1	1	1	1	1	1	1	1	1	1
1	1	1	1	1	1	1	1	1	1	1	1	1
597 6 6
18