16 17
6 7
2
0
0 0
1	1	1	1	1	1	1	1	1	1	1	1	1	1	1	1
1	1	1	1	1	1	1	1	1	1	1	1	1	1	1	1
1	1	1	1	1	1	1	1	1	1	1	1	1	1	1	1
1	1	1	34	34	34	34	34	34	34	34	34	34	1	1	1
1	1	1	34	35	35	35	35	35	35	35	35	34	1	1	1
1	1	1	34	35	35	35	35	35	35	35	35	34	1	1	1
1	1	1	34	35	35	35	35	35	35	35	35	34	1	1	1
1	1	1	34	40	40	40	40	40	40	40	40	34	1	1	1
1	1	1	34	40	40	40	40	40	40	40	40	34	1	1	1
1	1	1	34	40	40	40	40	40	40	40	40	34	1	1	1
1	1	1	34	40	40	40	40	40	40	40	40	34	1	1	1
1	1	1	34	40	40	40	40	40	40	40	40	34	1	1	1
1	1	1	34	34	34	40	34	34	34	34	34	34	1	1	1
1	1	1	1	1	1	0	1	1	1	1	1	1	1	1	1
1	1	1	1	1	1	1	1	1	1	1	1	1	1	1	1
1	1	1	1	1	1	1	1	1	1	1	1	1	1	1	1
1	1	1	1	1	1	1	1	1	1	1	1	1	1	1	1
598 9 6
599 6 13
25