25 26
4 14
1
9
0 0
1	1	1	1	1	1	1	1	1	1	1	1	1	1	1	1	1	1	1	1	1	1	1	1	1
1	1	1	1	1	1	1	1	1	1	1	1	1	1	1	1	1	1	1	1	1	1	1	1	1
1	1	1	1	1	1	1	1	1	1	1	1	1	1	1	1	1	1	1	1	1	1	1	1	1
1	1	1	1	1	1	1	7	7	7	7	7	7	7	7	7	7	7	1	1	1	1	1	1	1
1	1	1	1	1	1	1	7	7	7	7	7	7	7	7	7	7	7	1	1	1	1	1	1	1
1	1	1	1	1	1	1	7	7	7	7	7	7	7	7	7	7	7	1	1	1	1	1	1	1
1	1	1	1	1	1	1	7	7	7	7	7	7	7	7	7	7	7	1	1	1	1	1	1	1
1	1	1	1	1	1	1	7	7	7	7	7	7	7	7	7	7	7	1	1	1	1	1	1	1
1	1	1	1	1	1	1	7	7	7	7	7	7	7	7	7	7	7	1	1	1	1	1	1	1
1	1	1	1	1	1	1	7	7	7	7	7	7	7	7	7	7	7	1	1	1	1	1	1	1
1	1	1	1	1	1	1	7	7	7	7	7	7	7	7	7	7	7	1	1	1	1	1	1	1
1	1	1	1	1	1	1	7	7	7	7	7	7	7	7	7	7	7	1	1	1	1	1	1	1
1	1	1	1	1	1	20	7	7	7	7	7	7	7	7	7	7	7	1	1	1	1	1	1	1
1	1	1	1	1	20	1	7	7	7	7	7	7	7	7	7	7	7	1	1	1	1	1	1	1
1	1	1	0	20	1	1	35	35	35	35	35	35	35	35	35	35	35	1	1	1	1	1	1	1
1	1	1	1	1	1	1	35	35	35	35	35	35	35	35	35	35	35	1	1	1	1	1	1	1
1	1	1	1	1	1	1	35	35	35	35	35	35	35	35	35	35	35	1	1	1	1	1	1	1
1	1	1	1	1	1	1	35	35	35	35	35	35	35	35	35	35	35	1	1	1	1	1	1	1
1	1	1	1	1	1	1	35	35	35	35	35	35	35	35	35	35	35	1	1	1	1	1	1	1
1	1	1	1	1	1	1	35	35	35	35	35	35	35	35	35	35	35	1	1	1	1	1	1	1
1	1	1	1	1	1	1	35	35	35	35	35	35	35	35	35	35	35	1	1	1	1	1	1	1
1	1	1	1	1	1	1	35	35	35	35	35	35	35	35	35	35	35	1	1	1	1	1	1	1
1	1	1	1	1	1	1	35	35	35	35	35	35	35	35	35	35	35	1	1	1	1	1	1	1
1	1	1	1	1	1	1	1	1	1	1	1	1	1	1	1	1	1	1	1	1	1	1	1	1
1	1	1	1	1	1	1	1	1	1	1	1	1	1	1	1	1	1	1	1	1	1	1	1	1
1	1	1	1	1	1	1	1	1	1	1	1	1	1	1	1	1	1	1	1	1	1	1	1	1
629 3 14
32 128 416
32 160 384
32 192 352
33 128 448
33 160 416
33 192 384
93 128 480
93 160 448
93 192 416
38