31 42
7 29
0
0
0 0
1	1	1	1	1	1	1	1	1	1	1	1	1	1	1	1	1	1	1	1	1	1	1	1	1	1	1	1	1	1	1
1	1	1	1	1	1	1	1	1	1	1	1	1	1	1	1	1	1	1	1	1	1	1	1	1	1	1	1	1	1	1
1	1	1	1	1	1	1	1	1	1	1	1	1	1	1	1	1	1	1	1	1	1	1	1	1	1	1	1	1	1	1
1	1	1	1	1	1	1	1	1	1	1	1	1	1	1	1	1	1	29	29	29	29	29	29	29	29	29	29	1	1	1
1	1	1	1	1	1	1	1	1	1	1	1	1	1	1	1	1	1	29	29	29	29	29	29	29	29	29	29	1	1	1
1	1	1	1	1	1	1	1	1	1	1	1	1	1	1	1	1	1	29	29	29	29	29	29	29	29	29	29	1	1	1
1	1	1	1	1	1	1	1	1	1	1	1	1	1	1	1	1	1	29	29	29	29	29	29	29	29	29	29	1	1	1
1	1	1	1	1	1	1	1	1	1	1	1	1	1	1	1	1	1	29	29	29	29	29	29	29	29	29	29	1	1	1
1	1	1	1	1	1	1	1	1	1	1	1	1	1	1	1	1	1	29	29	29	29	29	29	29	29	29	29	1	1	1
1	1	1	1	1	1	1	1	1	1	1	1	1	1	1	1	1	1	29	29	29	29	29	29	29	29	29	29	1	1	1
1	1	1	1	1	1	1	1	1	1	1	1	1	1	1	1	1	1	29	29	29	29	29	29	29	29	29	29	1	1	1
1	1	1	1	1	1	1	1	1	1	1	1	1	1	1	1	1	1	29	29	29	29	29	29	29	29	29	29	1	1	1
1	1	1	34	34	34	34	34	34	34	34	34	34	34	34	34	34	34	29	29	29	29	29	29	29	29	29	29	1	1	1	
1	1	1	34	35	35	35	35	35	35	35	35	35	35	35	35	35	35	29	29	29	29	29	29	29	29	29	29	1	1	1	
1	1	1	34	35	35	35	35	35	35	35	35	35	35	35	35	35	35	29	29	29	29	29	29	29	29	29	29	1	1	1	
1	1	1	34	35	35	35	35	35	35	35	35	35	35	35	35	35	35	29	29	29	29	29	29	29	29	29	29	1	1	1	
1	1	1	34	40	40	40	40	40	40	40	40	40	40	40	40	40	40	29	29	29	29	29	29	29	29	29	29	1	1	1	
1	1	1	34	40	40	40	40	40	40	40	40	40	40	40	40	40	40	29	29	29	29	29	29	29	29	29	29	1	1	1	
1	1	1	34	40	40	40	40	40	40	40	40	40	40	40	40	40	40	29	29	29	29	29	29	29	29	29	29	1	1	1	
1	1	1	34	40	40	40	40	40	40	40	40	40	40	40	40	40	40	29	29	29	29	29	29	29	29	29	29	1	1	1	
1	1	1	34	40	40	40	40	40	40	40	40	40	40	40	40	40	40	29	29	29	29	29	29	29	29	29	29	1	1	1	
1	1	1	34	40	40	40	40	40	40	40	40	40	40	40	40	40	40	29	29	29	29	29	29	29	29	29	29	1	1	1	
1	1	1	34	40	40	40	40	40	40	40	40	40	40	40	40	40	40	29	29	29	29	29	29	29	29	29	29	1	1	1	
1	1	1	34	40	40	40	40	40	40	40	40	40	40	40	40	40	40	29	29	29	29	29	29	29	29	29	29	1	1	1	
1	1	1	34	40	40	40	40	40	40	40	40	40	40	40	40	40	40	29	29	29	29	29	29	29	29	29	29	1	1	1	
1	1	1	34	40	40	40	40	40	40	40	40	40	40	40	40	40	40	29	29	29	29	29	29	29	29	29	29	1	1	1	
1	1	1	34	40	40	40	40	40	40	40	40	40	40	40	40	40	40	29	29	29	29	29	29	29	29	29	29	1	1	1	
1	1	1	34	40	40	40	40	40	40	40	40	40	40	40	40	40	40	29	29	29	29	29	29	29	29	29	29	1	1	1	
1	1	1	34	40	40	40	40	40	40	40	40	40	40	40	40	40	40	29	29	29	29	29	29	29	29	29	29	1	1	1	
1	1	1	34	34	34	40	34	34	34	34	34	34	34	34	34	34	34	29	29	29	29	29	29	29	29	29	29	1	1	1
1	1	1	1	1	1	1	0	1	1	1	1	1	1	1	1	1	1	29	29	29	29	29	29	29	29	29	29	1	1	1
1	1	1	1	1	1	1	1	1	1	1	1	1	1	1	1	1	1	29	29	29	29	29	29	29	29	29	29	1	1	1
1	1	1	1	1	1	1	1	1	1	1	1	1	1	1	1	1	1	29	29	29	29	29	29	29	29	29	29	1	1	1
1	1	1	1	1	1	1	1	1	1	1	1	1	1	1	1	1	1	29	29	29	29	29	29	29	29	29	29	1	1	1
1	1	1	1	1	1	1	1	1	1	1	1	1	1	1	1	1	1	29	29	29	29	29	29	29	29	29	29	1	1	1
1	1	1	1	1	1	1	1	1	1	1	1	1	1	1	1	1	1	29	29	29	29	29	29	29	29	29	29	1	1	1
1	1	1	1	1	1	1	1	1	1	1	1	1	1	1	1	1	1	29	29	29	29	29	29	29	29	29	29	1	1	1
1	1	1	1	1	1	1	1	1	1	1	1	1	1	1	1	1	1	29	29	29	29	29	29	29	29	29	29	1	1	1
1	1	1	1	1	1	1	1	1	1	1	1	1	1	1	1	1	1	29	29	29	29	29	29	29	29	29	29	1	1	1
1	1	1	1	1	1	1	1	1	1	1	1	1	1	1	1	1	1	1	1	1	1	1	1	1	1	1	1	1	1	1
1	1	1	1	1	1	1	1	1	1	1	1	1	1	1	1	1	1	1	1	1	1	1	1	1	1	1	1	1	1	1
1	1	1	1	1	1	1	1	1	1	1	1	1	1	1	1	1	1	1	1	1	1	1	1	1	1	1	1	1	1	1
20