19 26
10 21
0
0
0 0
1	1	1	1	1	1	1	1	1	1	1	1	1	1	1	1	1	1	1
1	1	1	1	1	1	1	1	1	1	1	1	1	1	1	1	1	1	1
1	1	1	1	1	1	1	1	1	1	1	1	1	1	1	1	1	1	1
1	1	1	1	1	1	10	10	10	10	10	10	10	1	1	1	1	1	1
1	1	1	1	1	1	10	11	11	11	11	11	10	1	1	1	1	1	1
1	1	1	1	1	1	10	11	11	11	11	11	10	1	1	1	1	1	1
1	1	1	1	1	1	10	11	11	11	11	11	10	1	1	1	1	1	1
1	1	1	1	1	1	10	2	2	2	2	2	10	1	1	1	1	1	1
1	1	1	1	1	1	10	2	2	2	2	2	10	1	1	1	1	1	1
1	1	1	1	1	1	10	2	2	2	2	2	10	1	1	1	1	1	1
1	1	1	1	1	1	10	2	2	2	2	2	10	1	1	1	1	1	1
1	1	1	10	10	10	10	2	2	2	2	2	10	10	10	10	1	1	1
1	1	1	10	11	11	11	2	2	2	2	2	11	11	11	10	1	1	1
1	1	1	10	11	11	11	2	2	2	2	2	11	11	11	10	1	1	1
1	1	1	10	11	11	11	2	2	2	2	2	11	11	11	10	1	1	1
1	1	1	10	2	2	2	2	2	2	2	2	2	2	2	10	1	1	1
1	1	1	10	2	2	2	2	2	2	2	2	2	2	2	10	1	1	1
1	1	1	10	2	2	2	2	2	2	2	2	2	2	2	10	1	1	1
1	1	1	10	2	2	2	2	2	2	2	2	2	2	2	10	1	1	1
1	1	1	10	2	2	2	2	2	2	2	2	2	2	2	10	1	1	1
1	1	1	10	2	2	2	2	2	2	2	2	2	2	2	10	1	1	1
1	1	1	10	10	10	10	10	10	2	10	10	10	10	10	10	1	1	1
1	1	1	1	1	1	1	1	1	0	1	1	1	1	1	1	1	1	1
1	1	1	1	1	1	1	1	1	1	1	1	1	1	1	1	1	1	1
1	1	1	1	1	1	1	1	1	1	1	1	1	1	1	1	1	1	1
1	1	1	1	1	1	1	1	1	1	1	1	1	1	1	1	1	1	1
