19 26
9 21
8
5
0 0
1	1	1	1	1	1	1	1	1	1	1	1	1	1	1	1	1	1	1
1	1	1	1	1	1	1	1	1	1	1	1	1	1	1	1	1	1	1
1	1	1	1	1	1	1	1	1	1	1	1	1	1	1	1	1	1	1
1	1	1	1	1	1	10	10	10	10	10	10	10	1	1	1	1	1	1
1	1	1	1	1	1	10	11	11	11	11	11	10	1	1	1	1	1	1
1	1	1	1	1	1	10	11	11	11	11	11	10	1	1	1	1	1	1
1	1	1	1	1	1	10	11	11	11	11	11	10	1	1	1	1	1	1
1	1	1	1	1	1	10	2	2	2	2	2	10	1	1	1	1	1	1
1	1	1	1	1	1	10	2	2	2	2	2	10	1	1	1	1	1	1
1	1	1	1	1	1	10	2	2	2	2	2	10	1	1	1	1	1	1
1	1	1	1	1	1	10	2	2	2	2	2	10	1	1	1	1	1	1
1	1	1	10	10	10	10	2	2	2	2	2	10	10	10	10	1	1	1
1	1	1	10	11	11	11	2	2	2	2	2	11	11	11	10	1	1	1
1	1	1	10	11	11	11	2	2	2	2	2	11	11	11	10	1	1	1
1	1	1	10	11	11	11	2	2	2	2	2	11	11	11	10	1	1	1
1	1	1	10	2	2	2	2	2	2	2	2	2	2	2	10	1	1	1
1	1	1	10	2	2	2	2	2	2	2	2	2	2	2	10	1	1	1
1	1	1	10	2	2	2	2	2	2	2	2	2	2	2	10	1	1	1
1	1	1	10	2	2	2	2	2	2	2	2	2	2	2	10	1	1	1
1	1	1	10	2	2	2	2	2	2	2	2	2	2	2	10	1	1	1
1	1	1	10	2	2	2	2	2	2	2	2	2	2	2	10	1	1	1
1	1	1	10	10	10	10	10	10	2	10	10	10	10	10	10	1	1	1
1	1	1	1	1	1	1	1	1	0	1	1	1	1	1	1	1	1	1
1	1	1	1	1	1	1	1	1	1	1	1	1	1	1	1	1	1	1
1	1	1	1	1	1	1	1	1	1	1	1	1	1	1	1	1	1	1
1	1	1	1	1	1	1	1	1	1	1	1	1	1	1	1	1	1	1
315 9 22
56 9 12 
101 7 13
101 8 13
101 10 13
101 11 13
361 9 13
362 5 15
17 224 416
17 256 416
17 288 416
17 320 416
17 352 416
1