13 17
6 16
0
0 0
2   2   2   126 133 133 133 133 133 128 2   2   2
2   2   2   131 115 115 115 115 115 131 2   2   2
2   2   2   131 121 121 121 121 121 131 2   2   2
2   2   2   131 36  36  36  36  36  131 2   2   2
2   2   2   131 36  36  36  36  36  131 2   2   2
2   2   2   131 36  36  36  36  36  131 2   2   2
2   2   2   131 36  36  36  36  36  131 2   2   2
126 133 133 133 36  36  36  36  36  133 133 133 128
131 115 115 115 36  36  36  36  36  115 115 115 131
131 121 1   121 36  36  36  36  36  121 1   121 131
131 36  36  36  36  36  36  36  36  36  36  36  131
131 36  36  36  36  36  36  36  36  36  36  36  131
131 36  36  36  36  36  36  36  36  36  36  36  131
131 36  36  36  36  36  36  36  36  36  36  36  131
131 36  36  36  36  36  36  36  36  36  36  36  131
131 36  36  36  36  36  36  36  36  36  36  36  131
132 133 133 133 133 133 36  133 133 133 133 133 134
2   2   2   2   2   2   1   2   2   2   2   2   2   