18 30
11 20
4
5
0 0
1	1	1	1	1	1	1	1	1	1	1	1	1	1	1	1	1	1
1	1	1	1	1	1	1	1	1	1	1	1	1	1	1	1	1	1
1	1	1	1	1	1	1	1	1	1	1	1	1	1	1	1	1	1
1	1	1	10	10	10	10	10	10	10	1	1	1	1	1	1	1	1
1	1	1	10	11	11	11	11	11	10	1	1	1	1	1	1	1	1
1	1	1	10	11	11	11	11	11	10	1	1	1	1	1	1	1	1
1	1	1	10	11	11	11	11	11	10	1	1	1	1	1	1	1	1
1	1	1	10	2	2	2	2	2	10	1	1	1	1	1	1	1	1
1	1	1	10	2	2	2	2	2	10	1	1	1	1	1	1	1	1
1	1	1	10	2	2	2	2	2	10	1	1	1	1	1	1	1	1
1	1	1	10	2	2	2	2	2	10	10	10	10	10	10	1	1	1
1	1	1	10	2	2	2	2	2	11	11	11	11	11	10	1	1	1
1	1	1	10	2	2	2	2	2	11	11	11	11	11	10	1	1	1
1	1	1	10	2	2	2	2	2	11	11	11	11	11	10	1	1	1
1	1	1	10	2	2	2	2	2	2	2	2	2	2	10	1	1	1
1	1	1	10	2	2	2	2	2	2	2	2	2	2	10	1	1	1
1	1	1	10	2	2	2	2	2	2	2	2	2	2	10	1	1	1
1	1	1	10	2	2	2	2	2	2	2	2	2	2	10	1	1	1
1	1	1	10	2	2	2	2	2	2	2	2	2	2	10	1	1	1
1	1	1	10	2	2	2	2	2	2	2	2	2	2	10	1	1	1
1	1	1	10	2	2	2	2	2	10	10	2	10	10	10	1	1	1
1	1	1	10	2	2	2	2	2	10	1	0	1	1	1	1	1	1
1	1	1	10	2	2	2	2	2	10	1	1	1	1	1	1	1	1
1	1	1	10	2	2	2	2	2	10	1	1	1	1	1	1	1	1
1	1	1	10	2	2	2	2	2	10	1	1	1	1	1	1	1	1
1	1	1	10	2	2	2	2	2	10	1	1	1	1	1	1	1	1
1	1	1	10	10	10	10	10	10	10	1	1	1	1	1	1	1	1
1	1	1	1	1	1	1	1	1	1	1	1	1	1	1	1	1	1
1	1	1	1	1	1	1	1	1	1	1	1	1	1	1	1	1	1
1	1	1	1	1	1	1	1	1	1	1	1	1	1	1	1	1	1
56 6 11
316 11 21
361 6 12
363 6 24
17 128 384
17 160 384
17 192 384
17 224 384
17 256 384
1