11 15
5 10
1
1
0 0
1	1	1	1	1	1	1	1	1	1	1
1	1	1	1	1	1	1	1	1	1	1
1	1	1	1	1	1	1	1	1	1	1
1	1	1   10	10	10	10	10	1 	1	1
1	1	1	10	11	11	11	10	1	1	1
1	1	1	10	11	11	11	10	1	1	1
1	1	1	10	11	11	11	10	1	1	1
1	1	1	10	7	7	7	10	1	1	1
1	1	1	10	7	7	7	10	1	1	1
1	1	1	10	7	7	7	10	1	1	1
1	1	1	10	10	7	10	10	1	1	1
1	1	1	1	1	0	1	1	1	1	1
1	1	1	1	1	1	1	1	1	1	1
1	1	1	1	1	1	1	1	1	1	1
1	1	1	1	1	1	1	1	1	1	1
438 5 11
91 0 0
30