33 44
16 39
3
1
0 0
1	1	1	1	1	1	1	1	1	1	1	1	1	1	1	1	1	1	1	1	1	1	1	1	1	1	1	1	1	1	1	1	1
1	1	1	1	1	1	1	1	1	1	1	1	1	1	1	1	1	1	1	1	1	1	1	1	1	1	1	1	1	1	1	1	1
1	1	1	1	1	1	1	1	1	1	1	1	1	1	1	1	1	1	1	1	1	1	1	1	1	1	1	1	1	1	1	1	1
1	1	1	30	30	30	30	30	30	30	30	30	30	30	30	30	30	30	30	30	30	30	30	30	30	30	30	30	30	30	1	1	1
1	1	1	30	31	31	31	31	31	31	31	31	31	31	31	31	31	31	31	31	31	31	31	31	31	31	31	31	31	30	1	1	1	
1	1	1	30	31	31	31	31	31	31	31	31	31	31	31	31	31	31	31	31	31	31	31	31	31	31	31	31	31	30	1	1	1
1	1	1	30	31	31	31	31	31	31	31	31	31	31	31	31	31	31	31	31	31	31	31	31	31	31	31	31	31	30	1	1	1
1	1	1	30	24	24	24	24	24	24	24	24	24	24	24	24	24	24	24	24	24	24	24	24	24	24	24	24	24	30	1	1	1
1	1	1	30	24	24	24	24	24	24	24	24	24	24	24	24	24	24	24	24	24	24	24	24	24	24	24	24	24	30	1	1	1
1	1	1	30	24	24	24	24	24	24	24	24	24	24	24	24	24	24	24	24	24	24	24	24	24	24	24	24	24	30	1	1	1
1	1	1	30	24	24	24	24	24	24	24	24	24	24	24	24	24	24	24	24	24	24	24	24	24	24	24	24	24	30	1	1	1
1	1	1	30	24	24	24	24	24	24	24	24	24	24	24	24	24	24	24	24	24	24	24	24	24	24	24	24	24	30	1	1	1
1	1	1	30	24	24	24	24	24	30	30	30	30	30	30	18	18	18	30	30	30	30	30	30	24	24	24	24	24	30	1	1	1
1	1	1	30	24	24	24	24	24	30	31	31	31	31	31	18	18	18	31	31	31	31	31	30	24	24	24	24	24	30	1	1	1
1	1	1	30	24	24	24	24	24	30	29	29	29	29	29	29	29	29	29	29	29	29	29	30	24	24	24	24	24	30	1	1	1
1	1	1	30	24	24	24	24	24	30	29	29	29	29	29	29	29	29	29	29	29	29	29	30	24	24	24	24	24	30	1	1	1
1	1	1	30	24	24	24	24	24	30	29	29	29	29	29	29	29	29	29	29	29	29	29	30	24	24	24	24	24	30	1	1	1
1	1	1	30	24	24	24	24	24	30	29	29	29	29	29	29	29	29	29	29	29	29	29	30	24	24	24	24	24	30	1	1	1
1	1	1	30	24	24	24	24	24	30	29	29	29	29	29	29	29	29	29	29	29	29	29	30	24	24	24	24	24	30	1	1	1
1	1	1	30	24	24	24	24	24	30	29	29	29	29	29	29	29	29	29	29	29	29	29	30	24	24	24	24	24	30	1	1	1
1	1	1	30	24	24	24	24	24	30	29	29	29	29	29	29	29	29	29	29	29	29	29	30	24	24	24	24	24	30	1	1	1
1	1	1	30	24	24	24	24	24	30	29	29	29	29	29	29	29	29	29	29	29	29	29	30	24	24	24	24	24	30	1	1	1
1	1	1	30	24	24	24	24	24	30	29	29	29	29	29	29	29	29	29	29	29	29	29	30	24	24	24	24	24	30	1	1	1
1	1	1	30	24	24	24	24	24	30	29	29	29	29	29	29	29	29	29	29	29	29	29	30	24	24	24	24	24	30	1	1	1
1	1	1	30	24	24	24	24	24	30	29	29	29	29	29	29	29	29	29	29	29	29	29	30	24	24	24	24	24	30	1	1	1
1	1	1	30	24	24	24	24	24	30	29	29	29	29	29	29	29	29	29	29	29	29	29	30	24	24	24	24	24	30	1	1	1
1	1	1	30	24	24	24	24	24	30	29	29	29	29	29	29	29	29	29	29	29	29	29	30	24	24	24	24	24	30	1	1	1
1	1	1	30	24	24	24	24	24	30	29	29	29	29	29	29	29	29	29	29	29	29	29	30	24	24	24	24	24	30	1	1	1
1	1	1	30	24	24	24	24	24	30	29	29	29	29	29	29	29	29	29	29	29	29	29	30	24	24	24	24	24	30	1	1	1
1	1	1	30	24	24	24	24	24	30	29	29	29	29	29	29	29	29	29	29	29	29	29	30	24	24	24	24	24	30	1	1	1
1	1	1	30	24	24	24	24	24	30	29	29	29	29	29	29	29	29	29	29	29	29	29	30	24	24	24	24	24	30	1	1	1
1	1	1	30	24	24	24	24	24	30	29	29	29	29	29	29	29	29	29	29	29	29	29	30	24	24	24	24	24	30	1	1	1
1	1	1	30	24	24	24	24	24	30	29	29	29	29	29	29	29	29	29	29	29	29	29	30	24	24	24	24	24	30	1	1	1
1	1	1	30	24	24	24	24	24	30	30	30	30	30	30	30	19	30	30	30	30	30	30	30	24	24	24	24	24	30	1	1	1
1	1	1	30	24	24	24	24	24	24	24	24	24	24	24	24	24	24	24	24	24	24	24	24	24	24	24	24	24	30	1	1	1
1	1	1	30	24	24	24	24	24	24	24	24	24	24	24	24	24	24	24	24	24	24	24	24	24	24	24	24	24	30	1	1	1
1	1	1	30	24	24	24	24	24	24	24	24	24	24	24	24	24	24	24	24	24	24	24	24	24	24	24	24	24	30	1	1	1
1	1	1	30	24	24	24	24	24	24	24	24	24	24	24	24	24	24	24	24	24	24	24	24	24	24	24	24	24	30	1	1	1
1	1	1	30	24	24	24	24	24	24	24	24	24	24	24	24	24	24	24	24	24	24	24	24	24	24	24	24	24	30	1	1	1
1	1	1	30	30	30	30	30	30	30	30	30	30	30	30	30	24	30	30	30	30	30	30	30	30	30	30	30	30	30	1	1	1
1	1	1	1	1	1	1	1	1	1	1	1	1	1	1	1	0	1	1	1	1	1	1	1	1	1	1	1	1	1	1	1	1
1	1	1	1	1	1	1	1	1	1	1	1	1	1	1	1	1	1	1	1	1	1	1	1	1	1	1	1	1	1	1	1	1
1	1	1	1	1	1	1	1	1	1	1	1	1	1	1	1	1	1	1	1	1	1	1	1	1	1	1	1	1	1	1	1	1
1	1	1	1	1	1	1	1	1	1	1	1	1	1	1	1	1	1	1	1	1	1	1	1	1	1	1	1	1	1	1	1	1
422 16 40
423 6 6
424 25 6
91 0 0
16