17 19
10 14
0
0
0 0
1	1	1	1	1	1	1	1	1	1	1	1	1	1	1	1	1
1	1	1	1	1	1	1	1	1	1	1	1	1	1	1	1	1
1	1	1	1	1	1	1	1	1	1	1	1	1	1	1	1	1	
1	1	1	30	30	30	30	30	30	30	30	30	30	30	1	1	1
1	1	1	30	31	31	31	31	31	31	31	31	31	30	1	1	1
1	1	1	30	31	31	31	31	31	31	31	31	31	30	1	1	1
1	1	1	30	31	31	31	31	31	31	0	31	31	30	1	1	1
1	1	1	30	24	24	24	24	24	24	24	24	24	30	1	1	1
1	1	1	30	24	24	24	24	24	24	24	24	24	30	1	1	1
1	1	1	30	24	24	24	24	24	24	24	24	24	30	1	1	1
1	1	1	30	24	24	24	24	24	24	24	24	24	30	1	1	1
1	1	1	30	24	24	24	24	24	24	24	24	24	30	1	1	1
1	1	1	30	24	24	24	24	24	24	24	24	24	30	1	1	1
1	1	1	30	24	24	24	24	24	24	24	24	24	30	1	1	1
1	1	1	30	30	30	30	30	30	30	24	30	30	30	1	1	1
1	1	1	1	1	1	1	1	1	1	0	1	1	1	1	1	1
1	1	1	1	1	1	1	1	1	1	1	1	1	1	1	1	1
1	1	1	1	1	1	1	1	1	1	1	1	1	1	1	1	1
1	1	1	1	1	1	1	1	1	1	1	1	1	1	1	1	1
27