61 70
4 65
3
2
0 0
1	1	1	1	1	1	1	1	1	1	1	1	1	1	1	1	1	1	1	1	1	1	1	1	1	1	1	1	1	1	1	1	1	1	1	1	1	1	1	1	1	1	1	1	1	1	1	1	1	1	1	1	1	1	1	1	1	1	1	1	1
1	1	1	1	1	1	1	1	1	1	1	1	1	1	1	1	1	1	1	1	1	1	1	1	1	1	1	1	1	1	1	1	1	1	1	1	1	1	1	1	1	1	1	1	1	1	1	1	1	1	1	1	1	1	1	1	1	1	1	1	1
1	1	1	1	1	1	1	1	1	1	1	1	1	1	1	1	1	1	1	1	1	1	1	1	1	1	1	1	1	1	1	1	1	1	1	1	1	1	1	1	1	1	1	1	1	1	1	1	1	1	1	1	1	1	1	1	1	1	1	1	1
1	1	1	1	34	34	34	34	34	34	34	34	34	1	1	1	1	1	1	1	1	1	1	1	1	1	1	1	1	1	1	1	1	1	1	1	1	1	1	1	1	1	1	1	1	1	1	1	1	1	1	1	1	1	1	1	1	1	1	1	1
1	1	1	1	34	35	35	35	35	35	35	35	34	1	1	1	1	1	1	1	1	1	1	1	1	1	1	1	1	1	1	1	1	1	1	1	1	1	1	1	1	1	1	1	1	1	1	1	1	1	1	1	1	1	1	1	1	1	1	1	1
1	1	1	1	34	35	35	35	35	35	35	35	34	1	1	1	1	1	1	1	1	1	1	1	1	1	1	1	1	1	1	1	1	1	1	1	1	1	1	1	1	1	1	1	1	1	1	1	1	1	1	1	1	1	1	1	1	1	1	1	1
1	1	1	1	34	35	35	35	35	35	35	35	34	1	1	1	1	1	1	1	1	1	1	1	1	1	1	1	1	1	1	1	1	1	1	1	1	1	1	1	1	1	1	1	1	1	1	1	1	1	1	1	1	1	1	1	1	1	1	1	1
1	1	1	1	35	40	40	40	40	40	40	40	34	1	1	1	1	1	1	1	1	1	1	1	1	1	1	1	1	1	1	1	1	1	1	1	1	1	1	1	1	1	1	1	1	1	1	1	1	1	1	1	1	1	1	1	1	1	1	1	1
1	1	1	1	35	40	40	40	40	40	40	40	34	1	1	1	1	1	1	1	1	1	1	1	1	1	1	1	1	1	1	1	1	1	1	1	1	1	1	1	1	1	1	1	1	1	1	1	1	1	1	1	1	1	1	1	1	1	1	1	1
1	1	1	1	35	40	40	40	40	40	40	40	34	1	1	1	1	1	1	1	1	1	1	1	1	1	1	1	1	1	1	1	1	1	1	1	1	1	1	1	1	1	1	1	1	1	1	1	1	1	1	1	1	1	1	1	1	1	1	1	1
1	1	1	0	40	40	40	40	40	40	40	40	34	1	1	1	1	1	1	1	1	1	1	1	1	1	1	1	1	1	1	1	1	1	1	1	1	1	1	1	1	1	1	1	1	1	1	1	1	1	1	1	1	40	40	40	40	40	1	1	1
1	1	1	1	34	40	40	40	40	40	40	40	34	1	1	1	1	1	1	1	1	1	1	1	1	1	1	1	1	1	1	1	1	1	1	1	1	1	1	1	1	1	1	1	1	1	1	1	1	1	1	1	40	40	40	40	40	40	1	1	1
1	1	1	1	34	40	40	40	40	40	40	40	34	1	1	1	1	1	1	1	1	1	1	1	1	1	1	1	1	1	1	1	1	1	1	1	1	1	1	1	1	1	1	1	1	1	1	1	1	1	1	1	1	40	40	40	40	40	1	1	1
1	1	1	1	34	40	40	40	40	40	40	40	34	1	1	1	1	1	1	1	1	1	1	1	1	1	1	1	1	1	1	1	1	1	1	1	1	1	1	1	1	1	1	1	1	1	1	1	1	1	1	1	1	1	1	40	40	40	1	1	1
1	1	1	1	34	34	34	34	40	34	34	34	34	1	1	1	1	1	1	1	1	1	1	1	1	1	1	1	1	1	1	1	1	1	1	1	1	1	1	1	1	1	1	40	40	40	40	40	1	1	1	1	1	1	1	40	40	40	1	1	1
1	1	1	1	1	1	1	40	40	40	1	1	1	1	1	1	1	1	1	1	1	1	1	1	1	1	1	1	1	1	1	1	1	1	1	1	1	1	1	1	1	1	1	40	40	40	40	40	1	1	1	1	1	1	1	40	40	40	1	1	1
1	1	1	1	1	1	1	40	40	40	1	1	1	1	1	1	1	1	1	1	1	1	1	1	1	1	1	1	1	1	1	1	1	1	1	1	1	1	1	1	1	1	1	40	40	40	40	40	1	1	1	1	1	1	1	40	40	40	1	1	1
1	1	1	1	1	1	1	40	40	40	1	1	1	1	1	1	1	1	1	1	1	1	1	1	1	1	1	1	1	1	1	1	1	1	1	1	1	1	1	1	1	1	1	40	40	40	40	40	1	1	1	1	1	1	1	40	40	40	1	1	1
1	1	1	1	1	1	1	40	40	40	1	1	1	1	1	1	1	1	1	1	1	1	1	1	1	1	1	1	1	1	1	1	1	1	1	1	1	1	1	1	1	1	1	40	40	40	40	40	1	1	1	1	1	1	1	40	40	40	1	1	1
1	1	1	1	1	1	1	40	40	40	1	1	1	1	1	1	1	1	1	1	1	1	1	1	1	1	1	1	1	1	1	1	1	1	1	1	1	1	1	1	1	1	1	1	40	40	40	1	1	1	1	1	1	1	1	40	40	40	1	1	1
1	1	1	1	1	1	1	40	40	40	1	1	1	1	1	1	1	1	1	1	1	1	1	1	1	1	1	1	1	1	1	1	1	1	1	1	1	1	1	1	1	1	1	1	40	40	40	1	1	1	1	1	1	1	1	40	40	40	1	1	1
1	1	1	1	1	1	1	40	40	40	1	1	1	1	1	1	1	1	1	1	1	1	1	1	1	1	1	1	1	1	1	1	1	1	1	1	1	1	1	1	1	1	1	1	40	40	40	1	1	1	1	1	1	1	1	40	40	40	1	1	1
1	1	1	1	1	1	1	40	40	40	1	1	1	1	1	1	1	1	1	1	1	1	1	1	1	1	1	1	1	1	1	1	1	1	1	1	1	1	1	1	1	1	1	1	40	40	40	1	1	1	1	1	1	1	1	40	40	40	1	1	1
1	1	1	1	1	1	1	40	40	40	1	1	1	1	1	1	1	1	1	1	1	1	1	1	1	1	1	1	1	1	1	1	1	1	1	1	1	1	1	1	1	1	1	1	40	40	40	1	1	1	1	1	1	1	1	40	40	40	1	1	1
1	1	1	1	1	1	1	40	40	40	1	1	1	1	1	1	1	1	1	1	1	1	1	1	1	1	1	1	1	1	1	1	1	1	1	1	1	1	1	1	40	40	40	40	40	40	40	40	40	40	40	40	40	40	40	40	40	40	1	1	1
1	1	1	1	1	1	1	40	40	40	40	40	40	1	1	1	1	1	1	1	1	1	1	1	1	1	1	1	1	1	1	1	1	1	1	1	1	1	1	1	40	40	40	40	40	40	40	40	40	40	40	40	40	40	40	40	40	40	1	1	1
1	1	1	1	1	1	1	40	40	40	40	40	40	1	1	1	1	1	1	1	1	1	1	1	1	1	1	1	1	1	1	1	1	1	1	1	1	1	1	1	40	40	40	40	40	40	40	40	40	40	40	40	40	40	40	40	40	40	1	1	1
1	1	1	1	1	1	1	40	40	40	40	40	40	1	1	1	1	1	1	1	1	1	1	1	1	1	1	1	1	1	1	1	1	1	1	1	1	1	1	1	40	40	40	1	1	1	1	1	1	40	40	40	1	1	1	1	1	1	1	1	1
1	1	1	1	1	1	1	40	40	40	40	40	40	40	40	40	40	40	40	40	40	40	40	40	40	40	40	40	40	40	40	40	40	40	1	1	1	1	1	1	40	40	40	1	1	1	1	1	1	40	40	40	1	1	1	1	1	1	1	1	1
1	1	1	1	1	1	1	40	40	40	40	40	40	40	40	40	40	40	40	40	40	40	40	40	40	40	40	40	40	40	40	40	40	40	1	1	1	1	1	1	40	40	40	1	1	1	1	1	1	40	40	40	1	1	1	1	1	1	1	1	1
1	1	1	1	1	1	1	40	40	40	40	40	40	40	40	40	40	40	40	40	40	40	40	40	40	40	40	40	40	40	40	40	40	40	1	1	1	1	1	1	40	40	40	1	1	1	1	1	1	40	40	40	1	1	1	1	1	1	1	1	1
1	1	1	1	1	1	1	1	1	1	1	1	1	1	1	1	1	1	1	40	40	40	1	1	1	1	1	1	1	1	1	40	40	40	1	1	1	1	1	1	40	40	40	1	1	1	1	1	1	40	40	40	1	1	1	1	1	1	1	1	1
1	1	1	1	1	1	1	1	1	1	1	1	1	1	1	1	1	1	1	40	40	40	1	40	40	40	40	40	40	40	1	40	40	40	1	1	1	1	1	1	40	40	40	1	1	1	40	40	40	40	40	40	1	1	1	1	1	1	1	1	1
1	1	1	1	1	1	1	1	1	1	1	1	1	1	1	1	1	1	1	40	40	40	1	40	40	40	40	40	40	40	1	40	40	40	1	1	1	1	1	1	40	40	40	1	1	1	40	40	40	40	40	40	1	1	1	1	1	1	1	1	1
1	1	1	1	1	1	1	1	1	1	1	1	1	1	1	1	1	1	1	40	40	40	1	40	40	40	40	40	40	40	1	40	40	40	1	1	1	1	1	1	40	40	40	1	1	1	40	40	40	40	40	40	1	1	1	1	1	1	1	1	1
1	1	1	1	1	1	1	1	1	1	1	1	1	1	1	1	1	1	1	40	40	40	40	40	40	40	1	40	40	40	1	40	40	40	1	40	40	40	40	40	40	40	40	1	1	1	40	40	40	1	1	1	1	1	1	1	1	1	1	1	1	
1	1	1	1	1	1	1	1	1	1	1	1	1	1	1	1	1	1	1	40	40	40	40	40	40	40	1	40	40	40	1	40	40	40	1	40	40	40	40	40	40	40	40	1	1	1	40	40	40	1	1	1	1	1	1	1	1	1	1	1	1	
1	1	1	1	1	1	1	1	1	1	1	1	1	1	1	1	1	1	1	40	40	40	40	40	40	40	1	40	40	40	1	40	40	40	1	40	40	40	40	40	40	40	40	1	1	1	40	40	40	1	1	1	1	1	1	1	1	1	1	1	1	
1	1	1	1	1	1	1	1	1	1	1	1	1	1	1	1	1	1	1	1	1	1	1	1	1	1	1	40	40	40	1	40	40	40	1	40	40	40	1	1	1	1	1	1	1	1	40	40	40	1	1	1	1	1	1	1	1	1	1	1	1	
1	1	1	1	1	1	1	1	1	1	1	1	1	1	1	1	1	1	1	1	1	1	1	40	40	40	40	40	40	40	1	40	40	40	40	40	40	40	1	1	1	1	1	1	1	1	40	40	40	1	1	1	1	1	1	1	1	1	1	1	1	
1	1	1	1	1	1	1	1	1	1	1	1	1	1	1	1	1	1	1	1	1	1	1	40	40	40	40	40	40	40	1	40	40	40	40	40	40	40	1	1	1	1	1	1	1	1	40	40	40	1	1	1	1	1	1	1	1	1	1	1	1	
1	1	1	1	1	1	1	1	1	1	1	1	1	1	1	1	1	1	1	1	1	1	1	40	40	40	40	40	40	40	1	40	40	40	40	40	40	40	1	1	1	1	1	1	1	1	40	40	40	40	40	40	40	40	1	1	1	1	1	1	1	
1	1	1	1	1	1	1	1	1	1	1	1	1	1	1	1	1	1	1	1	1	1	1	40	40	40	1	1	1	1	1	1	1	1	1	1	1	1	1	1	1	1	1	1	1	1	40	40	40	40	40	40	40	40	1	1	1	1	1	1	1	
1	1	1	1	1	1	1	1	1	1	1	1	1	1	1	1	1	1	1	40	40	40	40	40	40	40	40	40	40	40	1	40	40	40	40	40	40	40	40	40	40	40	1	1	1	1	40	40	40	40	40	40	40	40	1	1	1	1	1	1	1	
1	1	1	1	1	1	1	1	1	1	1	1	1	1	1	1	1	1	1	40	40	40	40	40	40	40	40	40	40	40	1	40	40	40	40	40	40	40	40	40	40	40	1	1	1	1	40	40	40	1	1	1	1	1	1	1	1	1	1	1	1	
1	1	1	1	1	1	1	1	1	1	1	1	1	1	1	1	1	1	1	40	40	40	40	40	40	40	40	40	40	40	1	40	40	40	40	40	40	40	40	40	40	40	1	1	1	1	40	40	40	1	1	1	1	1	1	1	1	1	1	1	1	
1	1	1	1	1	1	1	1	1	1	1	1	1	1	1	1	1	1	1	40	40	40	1	1	1	1	1	40	40	40	1	40	40	40	1	1	1	1	1	40	40	40	1	1	1	1	40	40	40	1	1	1	1	1	1	1	1	1	1	1	1	
1	1	1	1	1	1	1	1	1	1	1	1	1	1	1	1	1	1	1	40	40	40	1	40	40	40	1	40	40	40	1	40	40	40	1	40	40	40	1	40	40	40	1	1	1	1	40	40	40	1	1	1	1	1	1	1	1	1	1	1	1	
1	1	1	1	1	1	1	1	1	1	1	1	1	1	1	40	40	40	1	40	40	40	1	40	40	40	1	40	40	40	1	40	40	40	1	40	40	40	1	40	40	40	1	1	1	1	40	40	40	1	1	1	1	1	1	1	1	1	1	1	1	
1	1	1	1	1	1	1	1	1	1	1	1	1	1	1	40	40	40	1	40	40	40	1	40	40	40	1	40	40	40	1	40	40	40	1	40	40	40	1	40	40	40	1	1	1	1	40	40	40	1	1	1	1	1	1	1	1	1	1	1	1	
1	1	1	1	1	40	40	40	40	40	40	40	1	1	1	40	40	40	1	40	40	40	1	40	40	40	1	40	40	40	1	40	40	40	1	40	40	40	1	40	40	40	1	40	40	40	40	40	40	1	1	1	1	1	1	1	1	1	1	1	1
1	1	1	1	1	40	40	40	40	40	40	40	1	1	1	40	40	40	1	40	40	40	1	40	40	40	1	40	40	40	40	40	40	40	1	40	40	40	1	40	40	40	1	40	40	40	40	40	40	1	1	1	1	1	1	1	1	1	1	1	1
1	1	1	1	1	40	40	40	40	40	40	40	1	1	1	40	40	40	1	40	40	40	1	40	40	40	1	40	40	40	40	40	40	40	1	40	40	40	1	40	40	40	1	40	40	40	40	40	40	1	1	1	1	1	1	1	1	1	1	1	1
1	1	1	1	1	40	40	40	40	40	40	40	1	1	1	40	40	40	1	40	40	40	1	40	40	40	1	40	40	40	40	40	40	40	1	40	40	40	1	40	40	40	1	1	1	1	1	1	1	1	1	1	1	1	1	1	1	1	1	1	1
1	1	1	1	1	40	40	40	40	40	40	40	1	1	1	40	40	40	1	1	1	1	1	40	40	40	1	1	1	1	1	1	1	1	1	40	40	40	1	40	40	40	1	1	1	1	1	1	1	1	1	1	1	1	1	1	1	1	1	1	1
1	1	1	1	1	40	40	40	40	40	40	40	1	1	1	40	40	40	40	40	40	40	40	40	40	40	1	1	1	1	1	1	1	1	1	40	40	40	1	40	40	40	1	1	1	1	1	1	1	1	1	1	1	1	1	1	1	1	1	1	1
1	1	1	1	1	1	1	40	40	40	1	1	1	1	1	40	40	40	40	40	40	40	40	40	40	40	1	1	1	1	1	1	1	1	1	40	40	40	1	40	40	40	1	1	1	1	1	1	1	1	1	1	1	1	1	1	1	1	1	1	1
1	1	1	1	1	1	1	40	40	40	1	1	1	1	1	40	40	40	40	40	40	40	40	40	40	40	1	1	1	1	1	1	1	1	1	40	40	40	1	40	40	40	1	1	1	1	1	1	1	1	1	1	1	1	1	1	1	1	1	1	1
1	1	1	1	1	1	1	40	40	40	1	1	1	1	1	1	1	1	1	1	1	1	1	40	40	40	1	1	1	1	1	1	1	1	1	40	40	40	1	40	40	40	1	1	1	1	1	1	1	1	1	1	1	1	1	1	1	1	1	1	1
1	1	1	1	1	1	1	40	40	40	1	1	1	1	1	1	1	1	1	40	40	40	40	40	40	40	40	40	40	40	40	40	40	40	40	40	40	40	40	40	40	40	1	1	1	1	1	1	1	1	1	1	1	1	1	1	1	1	1	1	1
1	1	1	1	1	1	1	40	40	40	1	1	1	1	1	1	1	1	1	40	40	40	40	40	40	40	40	40	40	40	40	40	40	40	40	40	40	40	40	40	40	40	1	1	1	1	1	1	1	1	1	1	1	1	1	1	1	1	1	1	1
1	1	1	1	1	1	1	40	40	40	1	1	1	1	1	1	1	1	1	40	40	40	40	40	40	40	40	40	40	40	40	40	40	40	40	40	40	40	40	40	40	40	1	1	1	1	1	1	1	1	1	1	1	1	1	1	1	1	1	1	1
1	1	1	1	1	1	1	40	40	40	1	1	1	1	1	1	1	1	1	40	40	40	1	1	1	1	1	1	1	1	1	1	1	1	1	1	1	1	1	1	1	1	1	1	1	1	1	1	1	1	1	1	1	1	1	1	1	1	1	1	1
1	1	1	40	40	40	40	40	40	40	40	40	40	40	40	40	40	40	40	40	40	40	1	1	1	1	1	1	1	1	1	1	1	1	1	1	1	1	1	1	1	1	1	1	1	1	1	1	1	1	1	1	1	1	1	1	1	1	1	1	1
1	1	1	40	40	40	40	40	40	40	40	40	40	40	40	40	40	40	40	40	40	40	1	1	1	1	1	1	1	1	1	1	1	1	1	1	1	1	1	1	1	1	1	1	1	1	1	1	1	1	1	1	1	1	1	1	1	1	1	1	1
1	1	1	40	40	40	40	40	40	40	40	40	40	40	40	40	40	40	40	40	40	40	1	1	1	1	1	1	1	1	1	1	1	1	1	1	1	1	1	1	1	1	1	1	1	1	1	1	1	1	1	1	1	1	1	1	1	1	1	1	1
1	1	1	1	40	1	1	1	1	1	1	1	1	1	1	1	1	1	1	1	1	1	1	1	1	1	1	1	1	1	1	1	1	1	1	1	1	1	1	1	1	1	1	1	1	1	1	1	1	1	1	1	1	1	1	1	1	1	1	1	1
1	1	1	1	1	1	1	1	1	1	1	1	1	1	1	1	1	1	1	1	1	1	1	1	1	1	1	1	1	1	1	1	1	1	1	1	1	1	1	1	1	1	1	1	1	1	1	1	1	1	1	1	1	1	1	1	1	1	1	1	1
1	1	1	1	1	1	1	1	1	1	1	1	1	1	1	1	1	1	1	1	1	1	1	1	1	1	1	1	1	1	1	1	1	1	1	1	1	1	1	1	1	1	1	1	1	1	1	1	1	1	1	1	1	1	1	1	1	1	1	1	1
1	1	1	1	1	1	1	1	1	1	1	1	1	1	1	1	1	1	1	1	1	1	1	1	1	1	1	1	1	1	1	1	1	1	1	1	1	1	1	1	1	1	1	1	1	1	1	1	1	1	1	1	1	1	1	1	1	1	1	1	1
434 4 66
435 52 11
436 3 10
91 0 0
73 0 0
30