47 37
16 32
4
25
0 0
1	1	1	1	1	1	1	1	1	1	1	1	1	1	1	1	1	1	1	1	1	1	1	1	1	1	1	1	1	1	1	1	1	1	1	1	1	1	1	1	1	1	1	1	1	1	1
1	1	1	1	1	1	1	1	1	1	1	1	1	1	1	1	1	1	1	1	1	1	1	1	1	1	1	1	1	1	1	1	1	1	1	1	1	1	1	1	1	1	1	1	1	1	1
1	1	1	1	1	1	1	1	1	1	1	1	1	1	1	1	1	1	1	1	1	1	1	1	1	1	1	1	1	1	1	1	1	1	1	1	1	1	1	1	1	1	1	1	1	1	1		
1	1	1	35	35	35	35	35	35	35	35	35	35	35	35	35	35	35	35	35	35	35	35	35	35	35	35	35	35	35	35	35	35	35	35	35	35	35	35	35	35	35	1	1	1	1	1
1	1	1	35	35	35	35	35	35	35	35	35	35	35	35	35	35	35	35	35	35	35	35	35	35	35	35	35	35	35	35	35	35	35	35	35	35	35	35	35	35	35	35	1	1	1	1
1	1	1	35	35	35	35	35	35	35	35	35	35	35	35	35	35	35	35	35	35	35	35	35	35	35	35	35	35	35	35	35	35	35	35	35	35	35	35	35	35	35	35	1	1	1	1
1	1	1	35	35	35	35	35	35	35	35	35	35	35	35	35	35	35	35	35	35	35	35	35	35	35	35	35	35	35	35	35	35	35	35	35	35	35	35	35	35	35	35	1	1	1	1
1	1	1	35	35	35	35	35	35	35	35	35	35	35	35	35	35	35	35	35	35	35	35	35	35	35	35	35	35	35	35	35	35	35	35	35	35	35	35	35	35	35	35	1	1	1	1
1	1	1	35	35	35	35	35	35	35	35	35	35	35	35	35	35	35	35	35	35	35	35	35	35	35	35	35	35	35	35	35	35	35	35	35	35	35	35	35	35	35	35	1	1	1	1
1	1	1	35	35	35	35	35	35	35	35	35	35	35	35	35	35	35	35	35	35	35	35	35	35	35	35	35	35	35	35	35	35	35	35	35	35	35	35	35	35	35	35	1	1	1	1
1	1	1	35	35	35	35	35	35	35	35	35	35	24	24	24	24	24	24	24	24	24	24	24	35	35	35	24	24	24	24	24	24	35	35	35	35	35	35	35	35	35	24	1	1	1	1
1	1	1	35	35	35	35	35	35	35	35	35	35	24	35	35	35	24	24	24	24	24	24	24	35	35	35	24	24	24	24	24	24	21	35	35	35	35	35	35	35	20	24	24	1	1	1
1	1	1	35	35	35	35	35	35	35	35	35	35	18	35	35	35	24	24	24	24	24	24	24	35	35	35	24	24	24	24	24	24	21	21	35	35	35	35	35	20	20	24	1	1	1	1
1	1	1	35	35	35	35	35	35	35	35	35	35	18	35	35	35	35	35	35	35	35	35	35	35	35	35	24	24	24	35	35	35	35	21	21	24	24	24	20	20	35	35	1	1	1	1
1	1	1	35	35	35	35	35	35	35	35	35	35	18	35	35	35	35	35	35	35	35	35	35	35	35	35	24	24	24	35	35	35	35	35	21	24	24	24	20	35	35	35	1	1	1	1
1	1	1	35	35	35	35	35	35	35	35	35	35	18	35	35	35	35	35	35	35	35	35	35	35	35	35	24	24	24	35	35	35	35	35	35	24	24	24	35	35	35	35	1	1	1	1
1	1	1	29	29	29	29	29	29	29	29	29	29	18	35	35	35	35	35	35	35	35	35	35	29	29	29	24	24	24	35	35	35	35	35	35	18	18	18	35	35	35	35	1	1	1	1
1	1	1	29	29	29	29	29	29	29	29	29	29	18	29	29	29	35	35	35	35	35	35	35	29	29	29	24	24	24	35	35	35	35	35	35	18	18	18	35	35	35	35	1	1	1	1
1	1	1	29	29	29	29	29	29	29	29	24	24	24	29	29	29	35	35	35	35	35	35	35	29	29	29	24	24	24	35	35	35	35	35	35	24	24	24	35	35	35	35	1	1	1	1
1	1	1	29	29	29	29	29	29	29	29	24	24	24	29	29	29	29	29	29	29	29	29	29	29	29	29	24	24	24	29	29	29	29	29	29	24	24	24	29	29	29	29	1	1	1	1
1	1	1	29	29	29	29	29	29	29	29	24	24	24	29	24	24	24	24	24	24	24	24	24	24	24	24	24	24	24	29	29	29	29	29	29	24	24	24	29	29	29	29	1	1	1	1
1	1	1	29	29	29	29	29	29	29	29	24	24	24	29	24	24	24	24	24	24	24	24	24	24	24	24	24	24	24	29	29	29	29	29	29	24	24	24	29	29	29	29	1	1	1	1
1	1	1	29	29	29	29	29	29	29	29	24	24	24	29	24	24	24	24	24	24	24	24	24	24	24	24	24	24	24	29	29	29	29	29	29	24	24	24	29	29	29	29	1	1	1	1
1	1	1	29	29	29	29	29	29	29	29	24	24	24	29	24	24	24	35	35	35	35	35	35	18	18	18	35	35	35	29	29	29	29	29	29	35	35	35	29	29	29	29	1	1	1	1
1	1	1	29	29	29	29	29	29	29	29	35	35	35	29	24	24	24	35	35	35	35	35	35	18	18	18	35	35	35	29	29	29	29	29	29	35	35	35	29	29	29	29	1	1	1	1
1	1	1	29	29	29	29	29	29	29	29	35	35	35	29	24	24	24	35	35	35	35	35	35	18	18	18	35	35	35	29	29	29	29	29	29	35	35	35	29	29	29	29	1	1	1	1
1	1	1	29	29	29	29	29	29	29	29	35	35	35	29	24	24	24	35	35	35	35	35	35	24	24	24	24	24	24	29	29	29	29	29	29	29	29	29	29	29	29	29	1	1	1	1
1	1	1	29	29	29	29	29	29	29	29	29	29	29	29	24	24	24	35	35	35	35	35	35	24	24	24	24	24	24	29	29	29	29	29	29	29	29	29	29	29	29	29	1	1	1	1
1	1	1	29	29	29	29	29	29	29	29	29	29	29	29	24	24	24	35	35	35	35	35	35	24	24	24	24	24	24	29	29	29	29	29	29	29	29	29	29	29	29	29	1	1	1	1
1	1	1	29	29	29	29	29	29	29	29	29	29	29	29	24	24	24	29	29	29	29	29	29	35	35	35	35	35	35	29	29	29	29	29	29	29	29	29	29	29	29	29	1	1	1	1
1	1	1	29	29	29	29	29	29	29	29	29	29	29	29	24	24	24	29	29	29	29	29	29	35	35	35	35	35	35	29	29	29	29	29	29	29	29	29	29	29	29	29	1	1	1	1
1	1	1	29	29	29	29	29	29	29	29	29	29	29	29	24	24	24	29	29	29	29	29	29	35	35	35	35	35	35	29	29	29	29	29	29	29	29	29	29	29	29	29	1	1	1	1
1	1	1	29	29	29	29	29	29	29	29	29	29	29	29	1	24	1	29	29	29	29	29	29	29	29	29	29	29	29	29	29	29	29	29	29	29	29	29	29	29	29	29	1	1	1	1
1	1	1	1	1	1	1	1	1	1	1	1	1	1	1	1	0	1	1	1	1	1	1	1	1	1	1	1	1	1	1	1	1	1	1	1	1	1	1	1	1	1	1	1	1	1	1
1	1	1	1	1	1	1	1	1	1	1	1	1	1	1	1	1	1	1	1	1	1	1	1	1	1	1	1	1	1	1	1	1	1	1	1	1	1	1	1	1	1	1	1	1	1	1
1	1	1	1	1	1	1	1	1	1	1	1	1	1	1	1	1	1	1	1	1	1	1	1	1	1	1	1	1	1	1	1	1	1	1	1	1	1	1	1	1	1	1	1	1	1	1
1	1	1	1	1	1	1	1	1	1	1	1	1	1	1	1	1	1	1	1	1	1	1	1	1	1	1	1	1	1	1	1	1	1	1	1	1	1	1	1	1	1	1	1	1	1	1
427 37 24
431 16 33
432 18 9
433 43 11
91 0 0 
36 1056 320
36 1088 352
36 1120 384
37 1056 352
37 1056 384
37 1088 384
37 1088 416
37 1120 416
37 1120 448
95 1056 416
95 1088 448
95 1120 480
32 1248 384
32 1280 352
32 1312 320
33 1248 416
33 1248 448
33 1280 384
33 1280 416
33 1312 352
33 1312 384
93 1248 480
93 1280 448
93 1312 416
27