

0
0 0


2   184 36  36  36  36  36  36  36  36  36  36  36  36  36  36  36  36  36  36  36  36  186 2
2   184 36  36  36  36  36  36  36  36  36  36  36  36  36  36  36  36  36  36  36  36  186 2
2   184 36  36  36  36  36  36  36  36  36  36  36  36  36  36  36  36  36  36  36  36  186 2
2   184 36  36  36  36  36  36  36  36  36  36  36  36  36  36  36  36  36  36  36  36  186 2
2   184 36  36  36  36  36  36  36  36  36  36  36  36  36  36  36  36  36  36  36  36  186 2
2   184 36  36  36  36  36  36  36  36  36  36  36  36  36  36  36  36  36  36  36  36  186 2
2   184 36  36  36  36  36  36  36  36  36  36  36  36  36  36  36  36  36  36  36  36  186 2
2   187 182 182 182 182 182 182 182 182 182 182 183 191 191 191 191 181 182 182 182 182 189 2
2   2   2   2   2   2   2   2   2   2   2   2   184 191 191 191 191 186 2   2   2   2   2   2
2   2   2   2   2   2   2   2   2   2   2   2   184 191 191 191 191 186 2   2   2   2   2   2
2   2   2   2   2   2   2   2   2   2   2   2   184 191 191 191 191 186 2   2   2   2   2   2
2   2   2   2   2   2   2   2   2   2   2   2   184 191 191 191 191 186 2   2   2   2   2   2
2   2   2   2   2   2   2   2   2   2   2   2   184 191 191 191 191 186 2   2   2   2   2   2
2   2   2   2   2   2   2   2   2   2   2   2   184 191 191 191 191 186 2   2   2   2   2   2
2   2   2   2   2   2   2   2   2   2   2   2   184 191 191 191 191 186 2   2   2   2   2   2
2   2   2   2   2   2   2   2   2   2   2   2   184 191 191 191 191 186 2   2   2   2   2   2
2   2   2   2   2   2   2   2   2   2   2   2   184 191 191 191 191 186 2   2   2   2   2   2
2   2   2   2   2   2   2   2   2   2   2   2   184 191 191 191 191 186 2   2   2   2   2   2
2   2   2   2   2   2   2   2   2   2   2   2   170 191 191 191 191 170 2   2   2   2   2   2
2   2   2   2   2   2   2   2   2   2   2   2   176 191 191 191 191 176 2   2   2   2   2   2
2   2   2   2   2   2   2   2   2   2   2   1   191 191 191 191 191 191 1   2   2   2   2   2
2   2   2   2   2   2   2   2   2   2   2   2   184 191 191 191 191 186 2   2   2   2   2   2
2   2   2   2   2   2   2   2   2   2   2   2   184 191 191 191 191 186 2   2   2   2   2   2
2   2   2   2   2   2   2   2   2   2   2   2   184 191 191 191 191 186 2   2   2   2   2   2
2   2   2   2   2   2   2   2   2   2   2   2   184 191 191 191 191 170 2   2   2   2   2   2
2   2   2   2   2   2   2   2   2   2   2   2   184 191 191 191 191 176 2   2   2   2   2   2
2   2   2   2   2   2   2   2   2   2   2   2   184 191 191 191 191 191 1   2   2   2   2   2
2   2   2   2   2   2   2   2   2   2   2   2   184 191 191 191 191 186 2   2   2   2   2   2
2   2   2   2   2   2   2   2   2   2   2   2   184 191 191 191 191 186 2   2   2   2   2   2
2   2   2   2   2   2   2   2   2   2   2   2   187 188 188 188 188 189 2   2   2   2   2   2



 
