

0
0 0
2   2   2   2   2   2   2   2   2   2   2   2   2   2   2   2   2   2   2   2   2   2   2   2   2   2   2   2   2
2   2   2   2   2   2   2   2   2   2   2   2   2   2   2   2   2   2   2   2   2   2   2   2   2   2   2   2   2
2   2   2   2   2   2   2   2   2   2   181 182 182 182 182 182 182 182 182 182 182 182 183 2   2   2   2   2   2
2   2   2   2   2   2   2   2   2   2   186 170 170 170 170 170 170 170 170 170 170 170 184 2   2   2   2   2   2
2   2   2   2   2   2   2   2   2   2   186 176 176 176 176 176 1   176 176 176 176 176 184 2   2   2   2   2   2
2   2   2   2   2   2   2   2   2   2   186 191 191 191 191 191 191 191 191 191 191 191 187 188 188 188 188 188 189
2   2   2   2   2   2   2   2   2   2   186 191 191 191 191 191 191 191 191 191 191 191 170 170 170 170 170 170 186
2   2   2   2   2   2   2   2   2   2   186 191 191 191 191 191 191 191 191 191 191 191 176 176 176 176 176 176 186
2   2   2   2   2   2   2   2   2   2   186 191 191 191 191 191 191 191 191 191 191 191 191 191 191 191 191 191 186
2   2   2   2   2   2   2   2   2   2   186 191 191 191 191 191 191 191 191 191 191 191 191 191 191 191 191 191 186
2   2   2   2   2   2   2   2   2   2   186 191 191 191 191 191 191 191 191 191 191 191 191 191 191 191 191 191 186
2   2   2   2   2   2   2   2   2   2   186 191 191 191 191 191 191 191 191 191 191 191 191 191 191 191 191 191 186
2   2   2   2   2   2   2   2   2   2   186 191 191 191 191 191 191 191 191 191 191 191 191 191 191 191 191 191 186
2   2   2   2   2   2   2   2   2   2   186 191 191 191 191 191 191 191 191 191 191 191 191 191 191 191 191 191 186
2   2   2   2   2   2   2   2   2   2   186 191 191 191 191 191 191 191 191 191 191 191 191 191 191 191 191 191 186
2   2   2   2   2   2   2   2   2   2   186 191 191 191 191 191 191 191 191 191 191 191 181 182 182 182 182 182 189
2   2   2   2   2   2   2   2   2   2   186 191 191 191 191 191 191 191 191 191 191 191 184 2   2   2   2   2   2
2   2   2   2   2   2   2   2   2   2   186 191 191 191 191 191 191 191 191 191 191 191 184 2   2   2   2   2   2
2   2   2   2   2   2   2   2   2   2   186 191 191 191 191 191 191 191 191 191 191 191 184 2   2   2   2   2   2
2   2   2   2   2   2   2   2   2   2   186 191 191 191 191 191 191 191 191 191 191 191 184 2   2   2   2   2   2
2   2   2   2   2   2   2   2   2   2   186 191 191 191 191 191 191 191 191 191 191 191 184 2   2   2   2   2   2
2   2   2   2   2   2   2   2   2   2   186 191 191 191 191 191 191 191 191 191 191 191 184 2   2   2   2   2   2
2   2   2   2   2   2   2   2   2   2   186 191 191 191 191 191 191 191 191 191 191 191 184 2   2   2   2   2   2
2   2   2   2   2   2   2   2   2   2   186 191 191 191 191 191 191 191 191 191 191 191 184 2   2   2   2   2   2
2   2   2   2   2   2   2   2   2   2   186 191 191 191 191 191 191 191 191 191 191 191 184 2   2   2   2   2   2
2   2   2   2   2   2   2   2   2   2   186 191 191 191 191 191 191 191 191 191 191 191 184 2   2   2   2   2   2
2   2   2   2   2   2   2   2   2   2   186 74  75  75  75  75  75  75  75  75  75  76  184 2   2   2   2   2   2
2   2   2   2   2   2   2   2   2   2   186 74  75  75  75  75  75  75  75  75  75  76  184 2   2   2   2   2   2
188 188 188 188 188 188 188 188 188 188 189 74  75  75  75  75  75  75  75  75  75  76  184 2   2   2   2   2   2
72  72  72  72  72  72  72  72  72  72  72  75  75  75  75  75  75  75  75  75  75  76  184 2   2   2   2   2   2
75  75  75  75  75  75  75  75  75  75  75  75  75  75  75  75  75  75  75  75  75  76  184 2   2   2   2   2   2
75  75  75  75  75  75  75  75  75  75  75  75  75  75  75  75  75  75  75  75  75  76  184 2   2   2   2   2   2




 
