

0
0 0
2   2   2   2   2   2   2   2   2   2   2   2   2   2   2   2   2
2   2   2   2   2   2   2   2   2   2   2   2   2   2   2   2   2
2   2   2   2   2   181 182 182 182 182 182 182 182 183 2   2   2
2   2   2   2   2   186 170 170 170 170 170 170 170 184 2   2   2
2   2   2   2   2   186 176 176 176 1   176 176 176 184 2   2   2
2   2   2   2   2   186 191 191 191 191 191 191 191 184 2   2   2
2   2   2   2   2   186 191 191 191 191 191 191 191 184 2   2   2
2   2   2   2   2   186 191 191 191 191 191 191 191 184 2   2   2
2   2   2   2   2   186 191 191 191 191 191 191 191 184 2   2   2
2   2   2   2   2   186 191 191 191 191 191 191 191 184 2   2   2
2   2   2   2   2   186 191 191 191 191 191 191 191 184 2   2   2
2   2   2   2   2   186 191 191 191 191 191 191 191 184 2   2   2
2   188 188 188 188 189 191 191 191 191 191 191 191 184 2   2   2
2   186 170 170 170 170 191 191 191 191 191 191 191 184 2   2   2
2   170 176 176 176 176 191 191 191 191 191 191 191 184 2   2   2
2   176 191 191 191 191 191 191 191 191 191 191 191 184 2   2   2
1   191 191 191 191 191 191 191 191 191 191 191 191 184 2   2   2
2   186 191 191 191 191 191 191 191 191 191 191 191 184 2   2   2
2   186 191 191 191 191 191 191 191 191 191 191 191 184 2   2   2
2   187 188 188 188 188 188 188 188 188 188 188 188 189 2   2   2

