16 14
1 8
1
0
0 0
2   2   2   2   2   2   181 188 188 188 183 2   2   2   2   2
2   2   2   2   2   2   186 170 170 170 184 2   2   2   2   2
2   2   2   2   2   2   186 176 1   176 184 2   2   2   2   2   
2   2   2   2   2   2   186 14  14  14  184 2   2   2   2   2   
2   181 188 188 188 188 189 14  14  14  189 188 188 188 188 183
2   189 170 170 170 170 170 14  14  14  170 170 170 170 170 186
2   170 176 176 176 176 176 14  14  14  176 176 176 176 176 186
2   176 14  14  14  14  14  14  14  14  14  14  14  14  14  186
1   14  14  14  14  14  14  14  14  14  14  14  14  14  14  186
2   185 14  14  14  14  14  14  14  14  14  14  14  14  14  186
2   185 14  14  14  14  14  14  14  14  14  14  14  14  14  186
2   185 14  14  14  14  14  14  14  14  14  14  14  14  14  186
2   185 14  14  14  14  14  14  14  14  14  14  14  14  14  186
2   187 188 188 188 188 188 188 188 188 188 188 188 188 188 189
14 0 8
