



2   2   2   2   2   2   2   2   2   2   2   2   2   2   2   2   2   2   2   2   2   2   2   2   183 191 191 191 191 191 186
2   2   2   2   2   2   2   2   2   2   2   2   2   2   2   2   2   2   2   2   2   2   2   2   183 191 191 191 191 191 186
2   2   2   2   2   2   2   2   2   2   2   2   2   2   2   2   2   2   2   2   2   2   2   2   183 191 191 191 191 191 186
2   2   2   2   2   2   2   2   2   2   2   2   2   2   2   2   2   2   2   2   2   2   2   2   183 191 191 191 191 191 186
2   2   2   2   2   2   2   2   2   2   2   2   2   2   2   2   2   2   2   2   2   2   2   2   183 191 191 191 191 191 186
2   2   2   2   2   2   2   2   2   2   2   2   181 188 188	188	191	188	188	188	188	188	188	188	189 191 191 191 191 191 186
2   2   2   2   2   2   2   2   2   2   2   2   170 170 170 170 170 170 170 170 170 170 170 170 170 191 191 191 191 191 186
2   2   2   2   2   2   2   2   2   2   2   2   176 176 176 176 176 176 176 176 176 176 176 176 176 191 191 191 191 191 186
2   2   2   2   2   2   2   2   2   2   2   2   191 191 191 191 191 191 191 191 191 191 191 191 191 191 191 191 191 191 186
2   2   2   2   2   2   2   2   2   2   2   2   191 191 191 191 191 191 191 191 191 191 191 191 191 191 191 191 191 191 186
2   2   2   2   2   2   2   2   2   2   2   2   191 191 191 191 191 191 191 191 191 191 191 191 191 191 191 191 191 191 186
2   2   2   2   2   2   2   2   2   2   2   2   191 191 191 191 191 191 191 191 191 191 191 191 191 191 191 191 191 191 186
2   2   2   2   2   2   2   2   2   2   2   2   191 191 191 191 191 191 191 191 191 191 191 191 191 191 191 191 191 191 186
2   2   2   2   2   2   2   2   2   2   2   2   181 188 188	188	191	188	188	188	188	188	188	188	188	188	188	188	188	188 189 
2   2   2   2   2   2   2   2   2   2   2   2   2   2   2   2   1   2   2   2   2   2   2   2   2   2   2   2   2   2   2
2   2   2   2   2   2   2   2   2   2   2   2   2   2   2   2   2   2   2   2   2   2   2   2   2   2   2   2   2   2   2
2   2   2   2   2   2   2   2   2   2   2   2   2   2   2   2   2   2   2   2   2   2   2   2   2   2   2   2   2   2   2





