




2   2   2   2   2   2   2   2   2   2   2   2   2   2   2   2   2   2   2   2   2   2   2   2   2   2   2   2   2   2
2   2   2   2   2   2   2   2   2   2   2   2   2   2   2   2   2   2   2   2   2   2   2   2   2   2   2   2   2   2
2   2   2   2   2   2   2   2   2   2   2   2   2   2   2   2   2   2   2   2   2   2   2   2   2   2   2   2   2   2
2   2   2   2   2   2   2   2   2   2   2   2   2   2   2   2   2   2   2   2   2   2   2   2   2   2   2   2   2   2
2   2   2   2   2   2   2   2   2   2   2   2   2   2   2   2   2   2   2   2   2   2   2   2   2   2   2   2   2   2
2   2   2   2   2   2   2   2   2   2   2   2   2   2   2   2   2   2   2   2   2   2   2   2   2   2   2   2   2   2
2   2   2   2   2   2   2   2   2   2   2   2   181 188 188	188	2  	188	188	188	183 2   2   2   2   2   2   2   2   2   
2   2   2   2   2   2   2   2   2   2   2   2   184 170 170 170 1   170 170 170 186 2   2   2   2   2   2   2   2   2   
2   2   2   2   2   2   2   2   2   2   2   2   184 176 176 176 191 176 176 176 186 2   2   2   2   2   2   2   2   2   
2   2   2   2   2   2   2   2   2   2   2   2   184 191 191 191 191 191 191 191 186 2   2   2   2   2   2   2   2   2   
2   2   2   2   2   2   2   2   2   2   2   2   184 191 191 191 191 191 191 191 186 2   2   2   2   2   2   2   2   2   
2   2   2   2   2   2   2   2   2   2   2   2   184 191 191 191 191 191 191 191 186 2   2   2   2   2   2   2   2   2   
2   2   2   2   2   2   2   2   2   2   2   2   184 191 191 191 191 191 191 191 186 2   2   2   2   2   2   2   2   2   
2   2   2   2   2   2   2   2   2   2   2   2   184 191 191 191 191 191 191 191 186 2   2   2   2   2   2   2   2   2   
2   2   2   2   181 188 188 188 188 188 188 188 189 191 191 191 191 191 191 191 186 2   2   2   2   2   2   2   2   2   
2   2   2   2   184 170 170 170 170 170 170 170 170 191 191 191 191 191 191 191 186 2   2   2   2   2   2   2   2   2   
2   2   2   2   184 176 176 176 176 176 176 176 176 191 191 191 191 191 191 191 186 2   2   2   2   2   2   2   2   2   
2   2   2   2   184 191 191 191 191 191 191 191 191 191 191 191 191 191 191 191 186 2   2   2   2   2   2   2   2   2   
2   2   2   188 189 191 191 191 191 191 191 191 191 191 191 191 191 191 191 191 186 2   2   2   2   2   2   2   2   2   
2   2   2   170 170 191 191 191 191 191 191 191 191 191 191 191 191 191 191 191 186 2   2   2   2   2   2   2   2   2   
2   2   2   176 176 191 191 191 191 191 191 191 191 191 191 191 191 191 191 191 186 2   2   2   2   2   2   2   2   2   
2   2   2   1   191 191 191 191 191 191 191 191 191 191 191 191 191 191 191 191 186 2   2   2   2   2   2   2   2   2   
2   2   2   188 183 191 191 191 191 191 191 191 191 191 191 191 191 191 191 191 186 2   2   2   2   2   2   2   2   2   
2   2   2   2   184 191 191 191 191 191 191 191 191 191 191 191 191 191 191 191 186 2   2   2   2   2   2   2   2   2   
2   2   2   2   184 191 191 191 191 191 191 191 191 191 191 191 191 191 191 191 186 2   2   2   2   2   2   2   2   2   
2   2   2   2   184 191 191 191 191 191 191 191 191 191 191 191 191 191 191 191 186 2   2   2   2   2   2   2   2   2
2   2   2   2   184 191 191 191 191 191 191 191 191 191 191 191 191 191 191 191 186 2   2   2   2   2   2   2   2   2   
2   2   2   2   184 191 191 191 191 191 191 191 191 191 191 191 191 191 191 191 186 2   2   2   2   2   2   2   2   2   
2   2   2   2   184 191 191 191 191 191 191 191 191 191 191 191 191 191 191 191 186 2   2   2   2   2   2   2   2   2   
2   2   2   2   188 188 188 188 188 188 188 188 183 191 191 191 191 191 191 191 186 2   2   2   2   2   2   2   2   2
2   2   2   2   2   2   2   2   2   2   2   2   186 191 191 191 191 191 191 191 186 2   2   2   2   2   2   2   2   2
2   2   2   2   2   2   2   2   2   2   2   2   186 191 191 191 191 191 191 191 186 2   2   2   2   2   2   2   2   2
2   2   2   2   2   2   2   2   2   2   2   2   186 191 191 191 191 191 191 191 186 2   2   2   2   2   2   2   2   2
2   2   2   2   2   2   2   2   2   2   2   2   186 191 191 191 191 191 191 191 186 2   2   2   2   2   2   2   2   2
2   2   2   2   2   2   2   2   2   2   2   2   186 191 191 191 191 191 191 191 186 2   2   2   2   2   2   2   2   2
2   2   2   2   2   2   2   2   2   2   2   2   186 191 191 191 191 191 191 191 186 2   2   2   2   2   2   2   2   2
2   2   2   2   2   2   2   2   2   2   2   2   187 188 188 188 191 188 188 188 189 2   2   2   2   2   2   2   2   2
2   2   2   2   2   2   2   2   2   2   2   2   2   2   2   2   1   2   2   2   2   2   2   2   2   2   2   2   2   2
2   2   2   2   2   2   2   2   2   2   2   2   2   2   2   2   2   2   2   2   2   2   2   2   2   2   2   2   2   2
2   2   2   2   2   2   2   2   2   2   2   2   2   2   2   2   2   2   2   2   2   2   2   2   2   2   2   2   2   2





