11 14	
5 9
3
0
0 0
1   1   1   1   1   1   1   1   1   1   1
1   1   1   1   1   1   1   1   1   1   1
1   1   1   1   1   1   1   1   1   1   1
1   1   1	8	8	8	8	8	1   1   1
1   1   1	8	9   9   9   8	1   1   1
1   1   1	8	9   9   9   8	1   1   1
1   1   1	8	9   9   9   8	1   1   1
1   1   1	8	53  53  53  8	1   1   1
1   1   1	8	53  53  53  8	1   1   1
1   1   1	8	53  53  53  8	1   1   1
1   1   1	8	8	0	8	8	1   1   1
1   1   1   1   1   1   1   1   1   1   1
1   1   1   1   1   1   1   1   1   1   1
1   1   1   1   1   1   1   1   1   1   1
215 5 6
216 5 10
53 6 6
1