22 17
10 6
11
11
0 0
1   1   1   1   1   1   1   1   1   1   1   1   1   1   1   1   1   1   1   1   1   1   
1   1   1   1   1   1   1   1   1   1   1   1   1   1   1   1   1   1   1   1   1   1   
1   1   1   1   1   1   1   1   10  10  10  10  10  1   1   1   1   1   1   1   1   1   
1   1   1   10  10  10  10  10  10  11  11  11  10  10  10  10  10  10  10  1   1   1
1   1   1   10  11  11  11  11  10  11  11  11  10  10  11  11  11  11  10  1   1   1
1   1   1   10  11  11  11  11  10  11  11  11  10  10  11  11  11  11  10  1   1   1
1   1   1   10  11  11  11  11  10  2   2   2   10  10  11  11  11  11  10  1   1   1
1   1   1   10  2   2   2   2   11  2   2   2   11  11  3   3	3	3	10  1   1   1
1   1   1   10  2   2   2   2   11  2   2   2   11  11  3   3	3	3	10  1   1   1
1   1   1   10  2   2   2   2   11  2   2   2   11  11  3   3	3	3	10  1   1   1
1   1   1   10  2   2   2   2   2   2   2   2   2   2   3   3	3	3	10  1   1   1
1   1   1   10  2   2   2   2   2   2   2   2   2   2   2   2   2   2   10  1   1   1
1   1   1   10  2   2   2   2   2   2   2   2   2   2   2   2   2   2   10  1   1   1
1   1   1   10  10  10  10  10  10  10  10  10  10  10  10  10  10  10  10  1   1   1
1   1   1   1   1   1   1   1   1   1   1   1   1   1   1   1   1   1   1   1   1   1   
1   1   1   1   1   1   1   1   1   1   1   1   1   1   1   1   1   1   1   1   1   1   
1   1   1   1   1   1   1   1   1   1   1   1   1   1   1   1   1   1   1   1   1   1   
1 10 5
79 7 7
79 7 8
81 6 7
81 5 7
85 12 9
96 16 7
96 17 7
139 6 7
139 7 8
139 8 7
0 224 144
1 224 192
2 160 195
3 528 192
4 384 272
19 128 224
21 304 192
22 128 288
23 256 256
24 416 272
25 176 288