22 17
10 6
16
14
0 0
1   1   1   1   1   1   1   1   1   1   1   1   1   1   1   1   1   1   1   1   1   1   
1   1   1   1   1   1   1   1   1   1   1   1   1   1   1   1   1   1   1   1   1   1   
1   1   1   1   1   1   1   1   10  10  10  10  10  1   1   1   1   1   1   1   1   1   
1   1   1   10  10  10  10  10  10  11  11  11  10  10  10  10  10  10  10  1   1   1
1   1   1   10  11  11  11  11  10  11  11  11  10  10  11  11  11  11  10  1   1   1
1   1   1   10  11  11  11  11  10  11  11  11  10  10  11  11  11  11  10  1   1   1
1   1   1   10  11  11  11  11  10  2   2   2   10  10  11  11  11  11  10  1   1   1
1   1   1   10  2   2   2   2   11  2   2   2   11  11  3   3	3	3	10  1   1   1
1   1   1   10  2   2   2   2   11  2   2   2   11  11  3   3	3	3	10  1   1   1
1   1   1   10  2   2   2   2   11  2   2   2   11  11  3   3	3	3	10  1   1   1
1   1   1   10  2   2   2   2   2   2   2   2   2   2   3   3	3	3	10  1   1   1
1   1   1   10  2   2   2   2   2   2   2   2   2   2   2   2   2   2   10  1   1   1
1   1   1   10  2   2   2   2   2   2   2   2   2   2   2   2   2   2   10  1   1   1
1   1   1   10  10  10  10  10  10  10  10  10  10  10  10  10  10  10  10  1   1   1
1   1   1   1   1   1   1   1   1   1   1   1   1   1   1   1   1   1   1   1   1   1   
1   1   1   1   1   1   1   1   1   1   1   1   1   1   1   1   1   1   1   1   1   1   
1   1   1   1   1   1   1   1   1   1   1   1   1   1   1   1   1   1   1   1   1   1   
1 10 5
43 7 8
44 6 7
44 5 7
45 12 9
46 13 9
47 4 10
47 4 11
48 8 10
49 4 7
50 16 7
50 17 7
98 14 7
101 15 7
101 16 9
101 17 9
0 224 144
1 224 192
2 160 195
3 480 192
4 384 272
19 128 224
21 304 192
22 128 288
23 256 256
24 416 272
25 176 304
26 448 192
27 512 256
28 512 128