22 28
12 14
12
5
0 0
2   2   2   2   2   184 173 173 173 173 173 173 173 173 173 173 173 173 186 2   2   2
2   2   2   2   2   184 173 173 173 173 173 173 173 173 173 173 173 173 186 2   2   2
2   2   2   2   2   184 173 173 173 173 173 173 173 173 173 173 173 173 186 2   2   2
2   2   2   2   2   184 173 173 173 173 173 173 173 173 173 173 173 173 186 2   2   2
2   2   2   2   2   184 173 173 173 173 173 173 173 173 173 173 173 173 186 2   2   2
2   2   2   2   2   184 176 176 176 176 176 176 176 176 176 176 176 176 186 2   2   2   
2   2   2   2   2   184 185 185 185 185 185 185 185 185 188 188 188 188 186 2   2   2
2   2   2   2   2   184 185 185 185 185 185 185 185 186 170 170 170 170 186 2   2   2
2   2   2   2   2   184 188 188 188 188 188 185 185 186 176 176 176 176 186 2   2   2
2   181 188 188 188 185 170 170 170 170 170 184 185 186 36  36  36  36  186 2   2   2
2   184 170 170 170 184 176 176 176 176 176 184 185 186 36  36  36  36  186 2   2   2
2   184 176 176 176 184 36  36  36  36  36  187 188 189 36  36  36  36  186 2   2   2
2   184 36  36  36  170 36  36  36  36  36  170 170 170 36  36  36  36  186 2   2   2
2   184 36  36  36  176 36  36  36  36  36  176 1   176 36  36  36  36  186 2   2   2
2   184 36  36  36  36  36  36  36  36  36  36  36  36  36  36  36  36  186 2   2   2
2   187 188 188 188 186 36  36  36  36  36  36  36  36  36  36  36  36  186 2   2   2
2   2   2   2   2   184 188 188 188 188 188 36  36  36  181 188 188 188 186 2   2   2
2   2   2   2   2   184 170 170 170 170 170 36  36  36  184 170 170 170 186 2   2   2
2   2   2   2   2   184 176 176 176 176 176 36  36  36  184 176 176 176 186 2   2   2
2   2   2   2   2   184 36  36  36  36  36  36  36  36  170 14  14  14  186 2   2   2
2   2   2   2   2   184 36  36  36  36  36  36  36  36  176 14  14  14  186 2   2   2
2   2   2   2   2   184 36  36  36  36  36  36  36  36  14  14  14  14  186 2   2   2
2   2   2   2   2   184 36  36  36  36  36  36  36  36  184 14  14  14  186 2   2   2
2   2   2   2   2   187 188 188 188 188 188 188 188 188 188 188 188 188 189 2   2   2
2   2   2   2   2   2   2   2   2   2   2   2   2   2   2   2   2   2   2   2   2   2
2   2   2   2   2   2   2   2   2   2   2   2   2   2   2   2   2   2   2   2   2   2
2   2   2   2   2   2   2   2   2   2   2   2   2   2   2   2   2   2   2   2   2   2
2   2   2   2   2   2   2   2   2   2   2   2   2   2   2   2   2   2   2   2   2   2
1 12 13
79 9 11
79 9 12
81 7 11
81 8 11
85 11 13
96 15 9
96 16 9
100 13 14
139 11 14
139 13 14
139 12 15
0 320 300
1 288 340
2 224 340
3 496 250
4 352 400