11 14	
5 9
3
0
0 0
1   1   1   1   1   1   1   1   1   1   1
1   1   1   1   1   1   1   1   1   1   1
1   1   1   1   1   1   1   1   1   1   1
1   1   1	8	8	8	8	8	1   1   1
1   1   1	8	9   9   9   8	1   1   1
1   1   1	8	9   9   9   8	1   1   1
1   1   1	8	9   9   9   8	1   1   1
1   1   1	8	55  55  55  8	1   1   1
1   1   1	8	55  55  55  8	1   1   1
1   1   1	8	55  55  55  8	1   1   1
1   1   1	8	8	0	8	8	1   1   1
1   1   1   1   1   1   1   1   1   1   1
1   1   1   1   1   1   1   1   1   1   1
1   1   1   1   1   1   1   1   1   1   1
53 6 6
313 5 10
314 5 6
1