11 14	
5 9
5
1
0 0
1   1   1   1   1   1   1   1   1   1   1
1   1   1   1   1   1   1   1   1   1   1
1   1   1   1   1   1   1   1   1   1   1
1   1   1	8	8	8	8	8	1   1   1
1   1   1	8	9   9   9   8	1   1   1
1   1   1	8	9   9   9   8	1   1   1
1   1   1	8	9   9   9   8	1   1   1
1   1   1	8	5   5   5   8	1   1   1
1   1   1	8	5   5   5   8	1   1   1
1   1   1	8	5   5   5   8	1   1   1
1   1   1	8	8	0	8	8	1   1   1
1   1   1   1   1   1   1   1   1   1   1
1   1   1   1   1   1   1   1   1   1   1
1   1   1   1   1   1   1   1   1   1   1
2 5 10
3 5 6
52 5 7
53 6 6
54 4 9
5 128 224
