11 14	
5 9
3
0
0 0
1   1   1   1   1   1   1   1   1   1   1
1   1   1   1   1   1   1   1   1   1   1
1   1   1   1   1   1   1   1   1   1   1
1   1   1	8	8	8	8	8	1   1   1
1   1   1	8	9   9   9   8	1   1   1
1   1   1	8	9   9   9   8	1   1   1
1   1   1	8	9   9   9   8	1   1   1
1   1   1	8	54  54  54  8	1   1   1
1   1   1	8	54  54  54  8	1   1   1
1   1   1	8	54  54  54  8	1   1   1
1   1   1	8	8	0	8	8	1   1   1
1   1   1   1   1   1   1   1   1   1   1
1   1   1   1   1   1   1   1   1   1   1
1   1   1   1   1   1   1   1   1   1   1
53 6 6
305 5 6
312 5 10
1