31 27
19 22
210
0
0 0
1	1	1	1	1	1	1	1	1	1	1	1	1	1	1	1	1	1	1	1	1	1	1	1	1	1	1	1	1	1	1
1	1	1	1	1	1	1	1	1	1	1	1	1	1	1	1	1	1	1	1	1	1	1	1	1	1	1	1	1	1	1
1	1	1	1	1	1	1	1	1	1	1	1	1	1	1	1	1	1	1	1	1	1	1	1	1	1	1	1	1	1	1
1	1	1	34	34	34	34	34	34	34	1	1	1	1	1	1	1	1	1	34	34	34	34	34	34	34	34	34	1	1	1
1	1	1	34	35	34	35	35	35	34	1	1	1	1	1	1	1	1	1	34	35	35	35	35	35	35	35	34	1	1	1
1	1	1	34	35	35	35	35	35	34	1	1	1	1	1	1	1	1	1	34	35	35	35	35	35	35	35	34	1	1	1
1	1	1	34	35	35	35	35	35	34	1	1	1	1	1	1	1	1	1	34	35	35	35	35	35	35	35	34	1	1	1
1	1	1	34	7	35	7	7	7	34	34	34	34	34	34	34	34	34	34	34	7	7	7	7	7	7	7	34	1	1	1
1	1	1	34	7	7	7	7	7	35	35	35	35	35	35	34	35	35	35	35	7	7	7	7	7	7	7	34	1	1	1
1	1	1	34	7	7	7	7	7	35	35	35	35	35	35	35	35	35	35	35	7	7	7	7	7	7	7	34	1	1	1
1	1	1	34	7	7	7	7	7	35	35	35	35	35	35	35	35	35	35	35	7	7	7	34	7	7	7	34	1	1	1
1	1	1	34	34	7	7	7	7	7	7	7	7	7	7	35	7	7	7	7	7	7	7	34	7	7	7	34	1	1	1
1	1	1	34	7	7	7	34	7	7	7	7	7	7	7	7	7	7	7	7	7	7	7	34	7	7	7	34	1	1	1
1	1	1	34	7	7	34	7	34	7	7	7	7	34	7	7	7	7	7	7	7	7	7	34	7	7	7	34	1	1	1
1	1	1	34	7	7	35	7	7	7	7	7	34	7	34	7	7	7	7	7	34	34	34	34	7	7	7	34	1	1	1
1	1	1	34	7	7	7	7	7	7	7	7	7	7	7	7	7	34	7	7	35	35	35	34	7	7	7	34	1	1	1
1	1	1	34	7	7	7	34	34	34	34	34	34	7	7	7	7	7	7	7	7	7	7	34	7	7	7	34	1	1	1
1	1	1	34	7	7	7	35	35	35	34	35	35	7	7	7	7	7	7	7	7	7	7	35	7	7	7	34	1	1	1
1	1	1	34	7	7	7	7	7	7	34	7	7	7	7	7	7	7	7	7	7	7	7	7	7	7	7	34	1	1	1
1	1	1	34	7	7	7	7	7	7	34	7	7	7	7	7	34	7	7	34	7	7	7	34	7	7	7	34	1	1	1
1	1	1	34	7	7	7	7	7	7	34	7	7	7	7	34	7	7	7	7	7	34	7	34	7	7	7	34	1	1	1
1	1	1	34	7	34	34	7	7	7	34	7	7	7	7	7	7	7	34	7	7	7	7	34	7	7	7	34	1	1	1
1	1	1	34	34	34	34	7	34	34	34	34	34	34	34	34	34	34	34	7	34	34	34	34	34	34	34	34	1	1	1
1	1	1	1	1	1	1	0	1	1	1	1	1	1	1	1	1	1	1	0	1	1	1	1	1	1	1	1	1	1	1
1	1	1	1	1	1	1	1	1	1	1	1	1	1	1	1	1	1	1	1	1	1	1	1	1	1	1	1	1	1	1
1	1	1	1	1	1	1	1	1	1	1	1	1	1	1	1	1	1	1	1	1	1	1	1	1	1	1	1	1	1	1
1	1	1	1	1	1	1	1	1	1	1	1	1	1	1	1	1	1	1	1	1	1	1	1	1	1	1	1	1	1	1
492 7 23
492 19 23
1004 4 7
1004 6 7
1004 7 7
1004 8 7
1004 23 7
1004 24 7
1004 25 7
1004 26 7
1004 4 8
1004 5 8
1004 6 8
1004 7 8
1004 8 8
1004 23 8
1004 24 8
1004 25 8
1004 26 8
1004 4 9
1004 5 9
1004 6 9
1004 7 9
1004 8 9
1004 23 9
1004 24 9
1004 25 9
1004 26 9
1004 4 10
1004 5 10
1004 6 10
1004 7 10
1004 8 10
1004 24 10
1004 25 10
1004 26 10
1004 5 11
1004 6 11
1004 7 11
1004 8 11
1004 9 11
1004 10 11
1004 11 11
1004 12 11
1004 13 11
1004 14 11
1004 16 11
1004 17 11
1004 18 11
1004 19 11
1004 20 11
1004 24 11
1004 25 11
1004 26 11
1004 4 12
1004 5 12
1004 6 12
1004 8 12
1004 9 12
1004 10 12
1004 11 12
1004 12 12
1004 13 12
1004 14 12
1004 15 12
1004 16 12
1004 17 12
1004 18 12
1004 19 12
1004 20 12
1004 21 12
1004 24 12
1004 25 12
1004 26 12
1004 4 13
1004 5 13
1004 7 13
1004 9 13
1004 10 13
1004 11 13
1004 12 13
1004 14 13
1004 15 13
1004 16 13
1004 17 13
1004 18 13
1004 19 13
1004 20 13
1004 21 13
1004 22 13
1004 4 14
1004 5 14
1004 7 14
1004 8 14
1004 9 14
1004 10 14
1004 11 14
1004 13 14
1004 15 14
1004 16 14
1004 17 14
1004 18 14
1004 19 14
1004 4 15
1004 5 15
1004 6 15
1004 7 15
1004 8 15
1004 9 15
1004 10 15
1004 11 15
1004 12 15
1004 13 15
1004 14 15
1004 15 15
1004 16 15
1004 18 15
1004 19 15
1004 4 16
1004 5 16
1004 6 16
1004 13 16
1004 14 16
1004 15 16
1004 16 16
1004 17 16
1004 18 16
1004 19 16
1004 20 16
1004 21 16
1004 22 16
1004 4 17
1004 5 17
1004 6 17
1004 13 17
1004 14 17
1004 15 17
1004 16 17
1004 17 17
1004 18 17
1004 19 17
1004 20 17
1004 21 17
1004 22 17
1004 4 18
1004 5 18
1004 6 18
1004 7 18
1004 8 18
1004 9 18
1004 11 18
1004 12 18
1004 13 18
1004 14 18
1004 15 18
1004 16 18
1004 17 18
1004 18 18
1004 19 18
1004 20 18
1004 21 18
1004 22 18
1004 23 18
1004 4 19
1004 5 19
1004 6 19
1004 7 19
1004 8 19
1004 9 19
1004 11 19
1004 12 19
1004 13 19
1004 14 19
1004 15 19
1004 17 19
1004 18 19
1004 20 19
1004 21 19
1004 22 19
1004 4 20
1004 5 20
1004 6 20
1004 7 20
1004 8 20
1004 9 20
1004 11 20
1004 12 20
1004 13 20
1004 14 20
1004 16 20
1004 17 20
1004 18 20
1004 19 20
1004 20 20
1004 22 20
1004 4 21
1004 7 21
1004 8 21
1004 9 21
1004 11 21
1004 12 21
1004 13 21
1004 14 21
1004 15 21
1004 16 21
1004 17 21
1004 19 21
1004 20 21
1004 21 21
1004 22 21
37