39 52
13 47
2
33
0 0
1	1	1	1	1	1	1	1	1	1	1	1	1	1	1	1	1	1	1	1	1	1	1	1	1	1	1	1	1	1	1	1	1	1	1	1	1	1	1
1	1	1	1	1	1	1	1	1	1	1	1	1	1	1	1	1	1	1	1	1	1	1	1	1	1	1	1	1	1	1	1	1	1	1	1	1	1	1
1	1	1	1	1	1	1	1	1	1	1	1	1	1	1	1	1	1	1	1	1	1	1	1	1	1	1	1	1	1	1	1	1	1	1	1	1	1	1
1	1	1	1	1	1	1	1	1	1	1	1	1	1	1	1	1	1	1	30	30	30	30	30	30	30	30	30	30	30	30	30	30	30	30	30	1	1	1
1	1	1	1	1	1	1	1	1	1	1	1	1	1	1	1	1	1	1	30	31	31	31	31	31	31	31	31	31	31	31	31	31	31	31	30	1	1	1
1	1	1	1	1	1	1	1	1	1	1	1	1	1	1	1	1	1	1	30	31	31	31	31	31	31	31	1	31	31	31	31	31	31	31	30	1	1	1
1	1	1	1	1	1	1	1	1	1	1	1	1	1	1	1	1	1	1	30	31	31	31	31	31	31	1	1	1	31	31	31	31	31	31	30	1	1	1
1	1	1	1	1	1	1	1	1	1	1	1	1	1	1	1	1	1	1	31	31	31	31	31	31	1	1	1	1	1	31	31	31	31	31	31	1	1	1
1	1	1	1	1	1	1	1	1	1	1	1	1	1	1	1	1	1	1	31	39	39	39	39	39	29	29	29	29	29	39	39	39	39	39	31	1	1	1
1	1	1	1	1	1	1	1	1	1	1	1	1	1	1	1	1	1	1	31	39	39	39	39	39	29	29	29	29	29	39	39	39	39	39	31	1	1	1
1	1	1	1	1	1	1	1	1	1	1	1	1	1	1	1	1	1	0	39	39	39	39	39	39	29	29	29	29	29	39	39	39	39	39	39	1	1	1
1	1	1	1	1	1	1	1	1	1	1	1	1	1	1	1	1	1	1	30	39	39	39	39	39	29	29	29	29	29	39	39	39	39	39	30	1	1	1
1	1	1	1	1	1	1	1	1	1	1	1	1	1	1	1	1	1	1	30	39	39	39	39	39	29	29	29	29	29	39	39	39	39	39	30	1	1	1
1	1	1	1	1	1	1	1	1	1	1	1	1	1	1	1	1	1	1	30	39	39	39	39	39	29	29	29	29	29	39	39	39	39	39	30	1	1	1
1	1	1	1	1	1	1	1	1	1	1	1	1	1	1	1	1	1	1	30	39	39	39	39	39	29	29	29	29	29	39	39	39	39	39	30	1	1	1
1	1	1	1	1	1	1	1	1	1	1	1	1	1	1	1	1	1	1	30	39	39	39	39	39	29	29	29	29	29	39	39	39	39	39	30	1	1	1
1	1	1	1	1	1	1	1	1	1	1	1	1	1	1	1	1	1	1	30	39	39	39	39	39	29	29	29	29	29	39	39	39	39	39	30	1	1	1
1	1	1	1	1	1	1	1	1	1	1	1	1	1	1	1	1	1	1	30	39	39	39	39	39	29	29	29	29	29	39	39	39	39	39	30	1	1	1
1	1	1	1	1	1	1	1	1	1	1	1	1	1	1	1	1	1	1	30	39	39	39	39	39	29	29	29	29	29	39	39	39	39	39	30	1	1	1
1	1	1	1	1	1	1	1	1	1	1	1	1	1	1	1	1	1	1	30	39	39	39	39	39	29	29	29	29	29	39	39	39	39	39	30	1	1	1
1	1	1	1	1	1	1	1	1	1	1	1	1	1	1	1	1	1	1	30	39	39	39	39	39	29	29	29	29	29	39	39	39	39	39	30	1	1	1
1	1	1	30	30	30	30	30	30	30	30	30	30	30	30	30	30	30	30	30	39	39	39	39	39	29	29	29	29	29	39	39	39	39	39	30	1	1	1
1	1	1	30	31	31	31	31	31	31	31	31	31	31	31	31	31	31	31	30	39	39	39	39	39	29	29	29	29	29	39	39	39	39	39	30	1	1	1
1	1	1	30	31	31	31	31	31	31	31	31	31	31	31	31	31	31	31	31	39	39	39	39	39	29	29	29	29	29	39	39	39	39	39	30	1	1	1
1	1	1	30	31	31	31	31	31	31	31	31	31	31	31	31	31	31	31	31	39	39	39	39	39	29	29	29	29	29	39	39	39	39	39	30	1	1	1
1	1	1	30	31	31	31	31	31	31	31	31	31	39	39	39	39	39	39	31	39	39	39	39	39	29	29	29	29	29	39	39	39	39	39	30	1	1	1
1	1	1	30	31	31	31	31	31	31	31	31	20	39	39	39	39	39	39	39	39	39	39	39	39	29	29	29	29	29	39	39	39	39	39	30	1	1	1
1	1	1	30	31	31	31	31	31	31	31	20	31	31	31	31	31	31	31	30	39	39	39	39	39	29	29	29	29	29	39	39	39	39	39	30	1	1	1
1	1	1	30	31	31	31	31	31	31	20	31	31	31	31	31	31	31	31	30	39	39	39	39	39	29	29	29	29	29	39	39	39	39	39	30	1	1	1
1	1	1	30	31	31	31	31	31	20	31	31	31	31	31	31	31	31	31	30	39	39	39	39	39	29	29	29	29	29	29	29	29	29	29	29	1	1	1
1	1	1	30	31	31	31	31	20	31	31	31	31	31	31	31	31	31	31	30	39	39	39	39	39	29	29	29	29	29	29	29	29	29	29	29	1	1	1
1	1	1	30	39	39	39	20	31	31	31	31	31	31	31	31	31	31	31	30	39	39	39	39	39	29	29	29	29	29	29	29	29	29	29	29	1	1	1
1	1	1	30	39	39	39	31	31	31	31	31	31	31	31	31	31	31	31	30	39	39	39	39	39	29	29	29	29	29	29	29	29	29	29	29	1	1	1
1	1	1	30	39	39	39	39	39	39	39	39	39	39	39	39	39	39	39	30	39	39	39	39	39	29	29	29	29	29	29	29	29	29	29	29	1	1	1
1	1	1	30	39	39	39	39	39	39	39	39	39	39	39	39	39	39	39	30	30	30	30	30	30	30	30	30	30	30	30	30	30	30	30	29	1	1	1
1	1	1	30	39	39	39	39	39	39	39	39	39	39	39	39	39	39	39	30	1	1	1	1	1	1	1	1	1	1	1	1	1	1	1	1	1	1	1
1	1	1	30	39	39	39	39	39	39	39	39	39	39	39	39	39	39	39	30	1	1	1	1	1	1	1	1	1	1	1	1	1	1	1	1	1	1	1
1	1	1	30	39	39	39	39	39	39	39	39	39	39	39	39	39	39	39	30	1	1	1	1	1	1	1	1	1	1	1	1	1	1	1	1	1	1	1
1	1	1	30	39	39	39	39	39	39	39	39	39	39	39	39	39	39	39	30	1	1	1	1	1	1	1	1	1	1	1	1	1	1	1	1	1	1	1
1	1	1	30	39	39	39	39	39	39	39	39	39	39	39	39	39	39	39	30	1	1	1	1	1	1	1	1	1	1	1	1	1	1	1	1	1	1	1
1	1	1	30	39	39	39	39	39	39	39	39	39	39	39	39	39	39	39	30	1	1	1	1	1	1	1	1	1	1	1	1	1	1	1	1	1	1	1
1	1	1	30	39	39	39	39	39	39	39	39	39	39	39	39	39	39	39	30	1	1	1	1	1	1	1	1	1	1	1	1	1	1	1	1	1	1	1
1	1	1	30	39	39	39	39	39	39	39	39	39	39	39	39	39	39	39	30	1	1	1	1	1	1	1	1	1	1	1	1	1	1	1	1	1	1	1
1	1	1	30	39	39	39	39	39	39	39	39	39	39	39	39	39	39	39	30	1	1	1	1	1	1	1	1	1	1	1	1	1	1	1	1	1	1	1
1	1	1	30	30	30	30	30	30	39	39	39	39	39	39	39	39	39	39	30	1	1	1	1	1	1	1	1	1	1	1	1	1	1	1	1	1	1	1
1	1	1	1	1	1	1	1	30	39	39	39	39	39	39	39	39	39	39	30	1	1	1	1	1	1	1	1	1	1	1	1	1	1	1	1	1	1	1
1	1	1	1	1	1	1	1	30	39	39	39	39	39	39	39	39	39	39	30	1	1	1	1	1	1	1	1	1	1	1	1	1	1	1	1	1	1	1
1	1	1	1	1	1	1	1	30	30	30	30	30	39	30	30	30	30	30	30	1	1	1	1	1	1	1	1	1	1	1	1	1	1	1	1	1	1	1
1	1	1	1	1	1	1	1	1	1	1	1	1	0	1	1	1	1	1	1	1	1	1	1	1	1	1	1	1	1	1	1	1	1	1	1	1	1	1
1	1	1	1	1	1	1	1	1	1	1	1	1	1	1	1	1	1	1	1	1	1	1	1	1	1	1	1	1	1	1	1	1	1	1	1	1	1	1
1	1	1	1	1	1	1	1	1	1	1	1	1	1	1	1	1	1	1	1	1	1	1	1	1	1	1	1	1	1	1	1	1	1	1	1	1	1	1
1	1	1	1	1	1	1	1	1	1	1	1	1	1	1	1	1	1	1	1	1	1	1	1	1	1	1	1	1	1	1	1	1	1	1	1	1	1	1
478 13 48
479 18 10
32 224 960
32 256 928
32 288 896
32 320 864
32 352 832
32 384 800
33 224 992
33 256 960
33 288 928
33 320 896
33 352 864
33 384 832
34 224 1024
34 256 992
34 288 960
34 320 928
34 352 896
34 384 864
35 256 1024
35 288 1024
35 288 992
35 320 1024
35 320 992
35 320 960
35 352 1024
35 352 992
35 352 960
35 352 928
35 384 1024
35 384 992
35 384 960
35 384 928
35 384 896
25