26 25
21 10
0
0
0 0
1	1	1	1	1	1	1	1	1	1	1	1	1	1	1	1	1	1	1	1	1	1	1	1	1	1
1	1	1	1	1	1	1	1	1	1	1	1	1	1	1	1	1	1	1	1	1	1	1	1	1	1
1	1	1	1	1	1	1	1	1	1	1	1	1	1	1	1	1	1	1	1	1	1	1	1	1	1
1	1	1	1	1	1	1	1	1	30	30	30	30	30	30	30	1	1	1	1	1	1	1	1	1	1
1	1	1	30	30	30	30	30	30	30	29	29	29	29	29	30	30	30	30	30	30	30	1	1	1	1
1	1	1	30	31	31	31	31	31	31	29	29	29	29	29	31	31	31	31	31	31	30	1	1	1	1
1	1	1	30	31	31	31	31	31	31	29	29	29	29	29	31	31	31	31	31	31	30	1	1	1	1
1	1	1	30	31	0	31	31	0	31	29	29	29	29	29	31	0	31	31	31	31	31	1	1	1	1
1	1	1	30	39	39	39	39	39	39	29	29	29	29	29	39	39	39	39	39	39	31	1	1	1	1
1	1	1	30	39	39	39	39	39	39	29	29	29	29	29	39	39	39	39	39	39	31	1	1	1	1
1	1	1	30	39	39	39	39	39	39	39	39	39	39	39	39	39	39	39	39	39	39	0	1	1	1
1	1	1	30	39	39	39	39	39	39	29	29	29	29	29	39	39	39	39	39	39	30	1	1	1	1
1	1	1	30	39	39	39	39	39	39	29	29	29	29	29	39	39	39	39	39	39	30	1	1	1	1
1	1	1	30	31	31	31	31	31	31	29	29	29	29	29	31	31	31	31	31	31	30	1	1	1	1	
1	1	1	30	29	29	29	29	29	29	29	29	29	29	29	29	29	29	29	29	29	30	1	1	1	1
1	1	1	30	29	29	29	29	29	29	29	29	29	29	29	29	29	29	29	29	29	30	1	1	1	1
1	1	1	30	29	29	29	29	29	29	29	29	29	29	29	29	29	29	29	29	29	30	1	1	1	1
1	1	1	30	29	29	29	29	29	29	29	29	29	29	29	29	29	29	29	29	29	30	1	1	1	1
1	1	1	30	29	29	29	29	29	29	29	29	29	29	29	29	29	29	29	29	29	30	1	1	1	1
1	1	1	30	29	29	29	29	29	29	29	29	29	29	29	29	29	29	29	29	29	30	1	1	1	1
1	1	1	30	29	29	29	29	29	29	29	29	29	29	29	29	29	29	29	29	29	30	1	1	1	1
1	1	1	30	29	29	29	29	29	29	29	29	29	29	29	29	29	29	29	29	29	30	1	1	1	1
1	1	1	1	1	1	1	1	1	1	1	1	1	1	1	1	1	1	1	1	1	1	1	1	1	1
1	1	1	1	1	1	1	1	1	1	1	1	1	1	1	1	1	1	1	1	1	1	1	1	1	1
1	1	1	1	1	1	1	1	1	1	1	1	1	1	1	1	1	1	1	1	1	1	1	1	1	1
26