26 25
21 10
6
0
0 0
1	1	1	1	1	1	1	1	1	1	1	1	1	1	1	1	1	1	1	1	1	1	1	1	1	1
1	1	1	1	1	1	1	1	1	1	1	1	1	1	1	1	1	1	1	1	1	1	1	1	1	1
1	1	1	1	1	1	1	1	1	1	1	1	1	1	1	1	1	1	1	1	1	1	1	1	1	1
1	1	1	1	1	1	1	1	1	30	30	30	30	30	30	30	1	1	1	1	1	1	1	1	1	1
1	1	1	30	30	30	30	30	30	30	29	29	29	29	29	30	30	30	30	30	30	30	1	1	1	1
1	1	1	30	31	31	31	31	31	31	29	29	29	29	29	31	31	31	31	31	31	30	1	1	1	1
1	1	1	30	31	31	31	31	31	31	29	29	29	29	29	31	31	31	31	31	31	30	1	1	1	1
1	1	1	30	31	31	31	31	31	31	29	29	29	29	29	31	31	31	31	31	31	31	1	1	1	1
1	1	1	30	39	39	39	39	39	39	29	29	29	29	29	39	39	39	39	39	39	31	1	1	1	1
1	1	1	30	39	39	39	39	39	39	29	29	29	29	29	39	39	39	39	39	39	31	1	1	1	1
1	1	1	30	39	39	39	39	39	39	39	39	39	39	39	39	39	39	39	39	39	39	0	1	1	1
1	1	1	30	39	39	39	39	39	39	29	29	29	29	29	39	39	39	39	39	39	30	1	1	1	1
1	1	1	30	39	39	39	39	39	39	29	29	29	29	29	39	39	39	39	39	39	30	1	1	1	1
1	1	1	30	31	31	31	31	31	31	29	29	29	29	29	31	31	31	31	31	31	30	1	1	1	1	
1	1	1	30	29	29	29	29	29	29	29	29	29	29	29	29	29	29	29	29	29	30	1	1	1	1
1	1	1	30	29	29	29	29	29	29	29	29	29	29	29	29	29	29	29	29	29	30	1	1	1	1
1	1	1	30	29	29	29	29	29	29	29	29	29	29	29	29	29	29	29	29	29	30	1	1	1	1
1	1	1	30	29	29	29	29	29	29	29	29	29	29	29	29	29	29	29	29	29	30	1	1	1	1
1	1	1	30	29	29	29	29	29	29	29	29	29	29	29	29	29	29	29	29	29	30	1	1	1	1
1	1	1	30	29	29	29	29	29	29	29	29	29	29	29	29	29	29	29	29	29	30	1	1	1	1
1	1	1	30	29	29	29	29	29	29	29	29	29	29	29	29	29	29	29	29	29	30	1	1	1	1
1	1	1	30	29	29	29	29	29	29	29	29	29	29	29	29	29	29	29	29	29	30	1	1	1	1
1	1	1	1	1	1	1	1	1	1	1	1	1	1	1	1	1	1	1	1	1	1	1	1	1	1
1	1	1	1	1	1	1	1	1	1	1	1	1	1	1	1	1	1	1	1	1	1	1	1	1	1
1	1	1	1	1	1	1	1	1	1	1	1	1	1	1	1	1	1	1	1	1	1	1	1	1	1
474 22 10
475 16 7
476 8 7
477 5 7
770 15 10
772 4 8
26