18 19
13 9
3
0
0 0
1	1	1	1	1	1	1	1	1	1	1	1	1	1	1	1	1	1
1	1	1	1	1	1	1	1	1	1	1	1	1	1	1	1	1	1
1	1	1	1	1	1	1	1	1	1	1	1	1	1	1	1	1	1
1	1	1	30	30	30	30	30	30	30	30	30	30	30	1	1	1	1
1	1	1	30	31	31	31	31	31	31	31	31	31	30	1	1	1	1
1	1	1	30	31	31	31	31	31	31	31	31	31	30	1	1	1	1
1	1	1	30	31	31	31	31	31	31	31	31	31	31	1	1	1	1
1	1	1	30	39	39	39	39	39	39	39	39	39	31	1	1	1	1
1	1	1	30	39	39	39	39	39	39	39	39	39	31	1	1	1	1
1	1	1	30	39	39	39	39	39	39	39	39	39	39	0	1	1	1
1	1	1	30	39	39	39	39	39	39	39	39	39	30	1	1	1	1
1	1	1	30	39	39	39	39	39	39	39	39	39	30	1	1	1	1
1	1	1	30	39	39	39	39	39	39	39	39	39	30	1	1	1	1
1	1	1	30	39	39	39	39	39	39	39	39	39	30	1	1	1	1
1	1	1	30	30	30	30	30	39	30	30	30	30	30	1	1	1	1
1	1	1	1	1	1	1	1	0	1	1	1	1	1	1	1	1	1
1	1	1	1	1	1	1	1	1	1	1	1	1	1	1	1	1	1
1	1	1	1	1	1	1	1	1	1	1	1	1	1	1	1	1	1
1	1	1	1	1	1	1	1	1	1	1	1	1	1	1	1	1	1
493 14 9
494 8 15
771 13 8
27