17 22
5 18
10
0
0 0
1	1	1	1	1	1	1	1	1	1	1	1	1	1	1	1	1
1	1	1	1	1	1	1	1	1	1	1	1	1	1	1	1	1
1	1	1	1	1	1	1	1	1	1	1	1	1	1	1	1	1
1	1	1	16  16  16  16  16  16  16  16  16	16  16 	1	1	1
1	1	1	16  17  17  17  17  17  17  17  17	17  16 	1	1	1
1	1	1	16  17  17  17  17  17  17  17  17	17  16 	1	1	1
1	1	1	16	17	17	17	17	17	17	17	17	17	16	1	1	1
1	1	1	16  14  14  14  14  14  14  14  14	14  16 	1	1	1
1	1	1	16  14  14  14  14  14  14  14  14	14  16 	1	1	1
1	1	1	16  14  14  14  14  14  14  14  14	14  16 	1	1	1
1	1	1	16  14  14  14  14  14  14  14  14	14  16 	1	1	1
1	1	1	16  14  14  14  14  14  14  14  14	14  16 	1	1	1
1	1	1	16  14  14  14  14  14  14  14  14	14  16 	1	1	1
1	1	1	16  14  14  14  14  14  14  14  14	14  16 	1	1	1
1	1	1	16  14  14  14  14  14  14  14  14	14  16 	1	1	1
1	1	1	16  14  14  14  14  14  14  14  14	14 	16 	1	1	1
1	1	1	16  14  14  14  14  14  14  14  14	14  16 	1	1	1
1	1	1	16  14  14  14  14  14  14  14  14	14  16 	1	1	1
1	1	1	16  16  14  16  16  16  16  16  16	16  16 	1	1	1
1	1	1	1	1	0	1	1	1	1	1	1	1	1	1	1	1  
1	1	1	1	1	1	1	1	1	1	1	1	1	1	1	1	1  
1	1	1	1	1	1	1	1	1	1	1	1	1	1	1	1	1  
16 5 19
73 6 16
74 8 16
75 5 15
76 5 13
77 5 11
78 5 7
79 11 15
80 6 8
81 10 16