16 20
5 16
17
4
1.6 1
1	1	1	1	1	1	1	1	1	1	1	1	1	1	1	1
1	1	1	1	1	1	1	1	1	1	1	1	1	1	1	1
1	1	1	1	1	1	1	1	1	1	1	1	1	1	1	1
1	1	1	16  16  16  16  16  16  16  16  16	16 	1	1	1
1	1	1	16  17  17  17  17  17  17  17  17	16 	1	1	1
1	1	1	16  17  17  17  17  17  17  17  17	16 	1	1	1
1	1	1	16	17	17	17	17	17	17	17	17	16	1	1	1
1	1	1	16  14  14  14  14  14  14  14  14	16 	1	1	1
1	1	1	16  14  14  14  14  14  14  14  14	16 	1	1	1
1	1	1	16  14  14  14  14  14  14  14  14	16 	1	1	1
1	1	1	16  14  14  14  14  14  14  14  14	16 	1	1	1
1	1	1	16  14  14  14  14  14  14  14  14	16 	1	1	1
1	1	1	16  14  14  14  14  14  14  14  14	16 	1	1	1
1	1	1	16  14  14  14  14  14  14  14  14	16 	1	1	1
1	1	1	16  14  14  14  14  14  14  14  14	16 	1	1	1
1	1	1	16  14  14  14  14  14  14  14  14	16 	1	1	1
1	1	1	16  16  14  16  16  16  16  16  16	16 	1	1	1
1	1	1	1	1	0	1	1	1	1	1	1	1	1	1	1  
1	1	1	1	1	1	1	1	1	1	1	1	1	1	1	1  
1	1	1	1	1	1	1	1	1	1	1	1	1	1	1	1  
16 5 17
73 7 14
74 8 14
75 6 13
76 6 12
77 6 11
78 6 10
79 10 13
80 7 7
81 9 14
101 7 10
101 8 10
101 9 10
101 9 11
101 9 12
101 10 7
101 11 7
44 240 160
47 320 192
47 352 192
60 224 266
7 10