17 24
13 11
2
0
0 0
1	1	1	1	1	1	1	1	1	1	1	1	1	1	1	1	1
1	1	1	1	1	1	1	1	1	1	1	1	1	1	1	1	1
1	1	1	1	1	1	1	1	1	1	1	1	1	1	1	1	1
1	1	1	16	16	16	16	16	16	16	16	16	16	16	1	1	1
1	1	1	16	17	17	17	17	17	17	17	17	17	16	1	1	1
1	1	1	16	17	17	17	17	17	17	17	17	17	16	1	1	1
1	1	1	16	17	17	17	17	17	17	17	17	17	16	1	1	1
1	1	1	16	17	17	17	14	14	14	14	14	14	16	1	1	1
1	1	1	16	17	17	17	14	14	14	14	14	14	17	1	1	1
1	1	1	16	17	17	17	14	14	14	14	14	14	17	1	1	1
1	1	1	16	17	17	17	14	14	14	14	14	14	17	1	1	1
1	1	1	16	17	17	17	14	14	14	14	14	14	14	0	1	1
1	1	1	16	17	17	17	14	14	14	14	14	14	16	1	1	1
1	1	1	16	17	17	17	17	17	17	16	16	16	16	1	1	1
1	1	1	16	14	14	14	17	17	17	16	1	1	1	1	1	1
1	1	1	16	14	14	14	17	17	17	16	1	1	1	1	1	1
1	1	1	16	14	14	14	14	14	14	16	1	1	1	1	1	1
1	1	1	16	14	14	14	14	14	14	16	1	1	1	1	1	1
1	1	1	16	14	14	14	14	14	14	16	1	1	1	1	1	1
1	1	1	16	14	14	14	14	14	14	16	1	1	1	1	1	1
1	1	1	16	16	16	16	16	16	16	16	1	1	1	1	1	1
1	1	1	1	1	1	1	1	1	1	1	1	1	1	1	1	1
1	1	1	1	1	1	1	1	1	1	1	1	1	1	1	1	1
1	1	1	1	1	1	1	1	1	1	1	1	1	1	1	1	1
38 14 11
119 9 11
1