12 11
10 6
7
0
0 0
2   188 188 188 188 188 188 188 188 188 188 2
2   186 170 170 170 170 170 170 170 170 186 2
2   186 176 176 176 176 176 176 176 176 186 2
2   186 27  28  28  28  28  28  28  29  186 2
2   186 30  31  31  31  31  31  31  32  186 2
2   186 30  31  31  31  31  31  31  32  170 2
2   186 30  31  31  31  31  31  31  32  176 2
2   186 30  31  31  31  31  31  31  31  28  1
2   186 30  31  31  31  31  31  31  32  186 2
2   186 33  34  34  34  34  34  34  35  186 2
2   187 188 188 188 188 188 188 188 188 189 2
34 11 7
121 3 2
90 2 1
90 4 2
90 5 1
90 6 1
90 8 2
