17 20
4 14
17
6
0 0
1	1	1	1	1	1	1	1	1	1	1	1	1	1	1	1	1
1	1	1	1	1	1	1	1	1	1	1	1	1	1	1	1	1
1	1	1	1	1	1	1	1	1	1	1	1	1	1	1	1	1
1	1	1	1	12  12  12  12  12  12  12  12  12  12 	1	1	1
1	1	1	1	12  13  13  13  13  13  13  13  13  12 	1	1	1
1	1	1	1	12  13  13  13  13  13  13  13  13  12 	1	1	1
1	1	1	1	12	13	13	13	13	13	13	13	13	12	1	1	1
1	1	1	1	12  14  14  14  14  14  14  14  14  12 	1	1	1
1	1	1	1	12  14  14  14  14  14  14  14  14  12 	1	1	1
1	1	1	1	12  14  14  14  14  14  14  14  14  12 	1	1	1
1	1	1	1	12  14  14  14  14  14  14  14  14  12 	1	1	1
1	1	1	1	13  14  14  14  14  14  14  14  14  12 	1	1	1
1	1	1	1	13  14  14  14  14  14  14  14  14  12 	1	1	1
1	1	1	1	13  14  14  14  14  14  14  14  14  12 	1	1	1
1	1	1	0	14  14  14  14  14  14  14  14  14  12 	1	1	1
1	1	1	1	12  14  14  14  14  14  14  14  14  12 	1	1	1
1	1	1	1	12  12  12  12  12  12  12  12  12  12 	1	1	1
1	1	1	1	1	1	1	1	1	1	1	1	1	1	1	1	1  
1	1	1	1	1	1	1	1	1	1	1	1	1	1	1	1	1  
1	1	1	1	1	1	1	1	1	1	1	1	1	1	1	1	1  
24 3 14
103 7 9
104 7 11
105 10 13
106 9 9
107 6 9
108 8 9
101 7 7
101 8 7
122 9 14
101 10 14
101 11 7
101 12 7
123 6 10
101 7 10
123 8 10
101 9 10
0 368 144
47 352 192
47 384 192
51 288 416
75 224 192
76 240 256