17 20
4 14
7
0
0 0
1	1	1	1	1	1	1	1	1	1	1	1	1	1	1	1	1
1	1	1	1	1	1	1	1	1	1	1	1	1	1	1	1	1
1	1	1	1	1	1	1	1	1	1	1	1	1	1	1	1	1
1	1	1	1	12  12  12  12  12  12  12  12  12  12 	1	1	1
1	1	1	1	12  13  13  13  13  13  13  13  13  12 	1	1	1
1	1	1	1	12  13  13  13  13  13  13  13  13  12 	1	1	1
1	1	1	1	12	13	13	13	13	13	13	13	13	12	1	1	1
1	1	1	1	12  15  15  15  15  15  15  15  15  12 	1	1	1
1	1	1	1	12  15  15  15  15  15  15  15  15  12 	1	1	1
1	1	1	1	12  15  15  15  15  15  15  15  15  12 	1	1	1
1	1	1	1	12  15  15  15  15  15  15  15  15  12 	1	1	1
1	1	1	1	13  15  15  15  15  15  15  15  15  12 	1	1	1
1	1	1	1	13  15  15  15  15  15  15  15  15  12 	1	1	1
1	1	1	1	13  15  15  15  15  15  15  15  15  12 	1	1	1
1	1	1	0	15  15  15  15  15  15  15  15  15  12 	1	1	1
1	1	1	1	12  15  15  15  15  15  15  15  15  12 	1	1	1
1	1	1	1	12  12  12  12  12  12  12  12  12  12 	1	1	1
1	1	1	1	1	1	1	1	1	1	1	1	1	1	1	1	1  
1	1	1	1	1	1	1	1	1	1	1	1	1	1	1	1	1  
1	1	1	1	1	1	1	1	1	1	1	1	1	1	1	1	1  
24 3 14
103 7 10
104 7 12
105 12 14
106 9 10
107 6 10
108 8 10