11 15
5 10
2
0
0 0
1	1	1	1	1	1	1	1	1	1	1
1	1	1	1	1	1	1	1	1	1	1
1	1	1	1	1	1	1	1	1	1	1
1	1	1   10	10	10	10	10	1 	1	1
1	1	1	10	11	11	11	10	1	1	1
1	1	1	10	11	11	11	10	1	1	1
1	1	1	10	11	11	11	10	1	1	1
1	1	1	10	7	7	7	10	1	1	1
1	1	1	10	7	7	7	10	1	1	1
1	1	1	10	7	7	7	10	1	1	1
1	1	1	10	10	7	10	10	1	1	1
1	1	1	1	1	0	1	1	1	1	1
1	1	1	1	1	1	1	1	1	1	1
1	1	1	1	1	1	1	1	1	1	1
1	1	1	1	1	1	1	1	1	1	1
102 5 8
17 5 11