16 24
5 8
2
0 0
190 190 190 190 190 190 2   2   2   2   2   2   2   2   2   2
190 190 190 190 190 190 2   2   2   2   2   2   2   2   2   2
190 190 190 190 190 190 2   2   2   2   2   2   2   2   2   2
2   2   2   2   2   2   2   2   2   2   2   2   2   2   2   2
2   2   2   2   2   2   2   2   2   2   2   2   2   2   2   2
2   2   2   2   2   2   2   2   2   2   2   2   2   2   2   2
2   2   2   190 190 190 2   2   2   190 190 190 190 190 190 190
2   2   2   190 190 190 2   2   2   190 190 190 190 190 190 190
2   2   2   190 190 190 2   2   2   190 190 190 190 190 190 190
2   2   2   190 190 190 2   2   2   190 190 190 2   2   2   2
2   2   2   190 190 190 2   2   2   190 190 190 2   2   2   2
2   2   2   190 190 190 2   2   2   190 190 190 2   2   2   2
2   2   2   190 190 190 2   2   2   190 190 190 190 190 190 190
2   2   2   190 190 190 2   2   2   190 190 190 190 190 190 190
2   2   2   190 190 190 2   2   2   190 190 190 190 190 190 190
2   2   2   190 190 190 2   2   2   2   2   2   2   2   2   2
2   2   2   190 190 190 2   2   2   2   2   2   2   2   2   2
2   2   2   190 190 190 2   2   2   2   2   2   2   2   2   2
2   190 190 190 190 190 2   2   2   2   2   2   2   2   2   2
2   190 190 190 190 190 2   2   2   2   2   2   2   2   2   2
2   190 190 190 190 190 2   2   2   2   2   2   2   2   2   2
2   190 190 190 190 190 2   2   2   2   2   2   2   2   2   2
2   190 190 190 190 190 2   2   2   2   2   2   2   2   2   2
2   2   2   2   2   2   2   2   2   2   2   2   2   2   2   2
127 1 18
126 4 6
