19 18
9 14
18
11
0 0
1   1   1   1   1   1   1   1   1   1   1	1	1	1	1	1	1	1	1
1   1   1   1   1   1   1   1   1   1   1	1	1	1	1	1	1	1	1
1   1   1   1   1   1   1   1   1   1   1	1	1	1	1	1	1	1	1
1	1	1	1	16	16	16	16	16	16	16	16	16	16	16	16	1	1	1
1	1	1   16	16	17	17	17	17	17	17	17	17	17	17	16	1	1	1
1	1	1   17	17  17	17	17	17	17	17	17	17	17	17	17	1	1	1
1	1	1   17	17  17	17	17	17	17	17	17	17	17	17	17	1	1	1
1	1	1   17	17	6	6	6	6	6	6	6	6	6	6	17	1	1	1
1	1	0   4	4	6	6	6	6	6	6	6	6	6	6	6	0	1	1
1	1	1   16	16	6	6	6	6	6	6	6	6	6	16	16	1	1	1
1	1	1	1   16	6	6	6	6	6	6	6	6	6	16	1	1	1	1
1	1	1	1   16	6	6	6	6	6	6	6	6	6	16	1	1	1	1
1	1	1	1   16	6	6	6	4	4	4	6	6	6	16	1	1	1	1
1	1	1	1   16	6	6	6	4	4	4	6	6	6	16	1	1	1	1
1	1	1	1   16	16	16	16	16	4	16	16	16	16	16	1	1	1	1
1   1   1   1   1   1   1   1   1   0   1	1	1	1	1	1	1	1	1
1   1   1   1   1   1   1   1   1   1   1	1	1	1	1	1	1	1	1
1   1   1   1   1   1   1   1   1   1   1	1	1	1	1	1	1	1	1
4 9 15 
5 2 8
6 16 8
41 9 8
42 9 9
43 5 12
44 13 7
103 14 7
104 14 8
101 7 7
101 7 8
101 7 9
101 8 9
101 10 9
101 11 9
101 11 8
101 11 7
137 9 13
0 192 144
10 224 192
13 224 224
13 224 256
16 224 288
17 256 288
17 320 288
18 352 288
12 352 192
15 352 224
15 352 256

