15 12
7 9
21
11
0 0
2   2   126 133 133 133 133 133 133 133 133 133 133 128 2
2   132 134 115 115 115 115 115 115 115 115 115 115 115 2
2   115 115 121 121 121 121 1   121 121 121 121 121 121 2
2   121 121 27  28  28  28  28  28  28  28  28  29  37  2
1   27  28  31  31  31  31  31  31  31  31  31  31  29  1  
2   132 128 30  31  31  31  31  31  31  31  32  126 134 2
2   2   131 30  31  31  31  31  31  31  31  32  131 2   2
2   2   131 30  31  31  31  31  31  31  31  32  131 2   2
2   2   131 30  31  31  31  31  31  31  31  32  131 2   2
2   2   131 33  34  35  126 31  127 33  34  35  131 2   2
2   2   132 127 127 127 134 34  132 127 127 127 134 2   2
2   2   2   2   2   2   2   1   2   2   2   2   2   2   2
4 7 11 
5 0 4
6 14 4
41 7 4
42 7 5
43 3 7
44 11 4
103 12 3
104 12 4
105 13 1
101 5 2
101 5 3
101 5 4
101 5 5
101 6 5
101 8 5
101 9 5
101 9 2
101 9 3
101 9 4
137 7 8
0 128 32
10 160 64
13 160 96
13 160 128
16 160 160
17 192 160
17 256 160
18 288 160
12 288 64
15 288 96
15 288 128

