18 18
4 12
12
5
0 0
1	1	1	1	1	1	1	1	1	1	1	1	1	1	1	1	1	1
1	1	1	1	1	1	1	1	1	1	1	1	1	1	1	1	1	1
1	1	1	1	1	1	1	1	1	1	1	1	1	1	1	1	1	1
1	1	1	1	16	16	16	16	16	16	16	16	16	16	16	1	1	1
1	1	1	1	16	17	17	17	17	17	17	17	17	17	16	1	1	1
1	1	1	1	16	17	17	17	17	17	17	17	17	17	16	1	1	1
1	1	1	1	16	17	17	17	17	17	17	17	17	17	16	1	1	1
1	1	1	1	16	17	17	17	17	17	17	17	17	17	16	1	1	1
1	1	1	1	16	14	14	14	14	14	14	14	14	14	16	1	1	1
1	1	1	1	17	14	14	14	14	14	14	14	14	14	16	1	1	1
1	1	1	1	17	14	14	14	14	14	14	14	14	14	16	1	1	1
1	1	1	1	17	14	14	14	14	14	14	14	14	14	16	1	1	1
1	1	1	0	14	14	14	14	14	14	14	14	14	14	16	1	1	1
1	1	1	1	16	14	14	14	14	14	14	14	14	14	16	1	1	1
1	1	1	1	16	16	16	16	16	16	16	16	16	16	16	1	1	1
1	1	1	1	1	1	1	1	1	1	1	1	1	1	1	1	1	1
1	1	1	1	1	1	1	1	1	1	1	1	1	1	1	1	1	1
1	1	1	1	1	1	1	1	1	1	1	1	1	1	1	1	1	1
42 3 12
100 8 10
99 8 9
99 9 10
99 9 9
99 10 9
99 10 10
99 11 9
99 11 10
99 12 9
99 12 10
132 5 10
79 160 160
79 224 160
79 288 160
79 352 160
47 416 192
2