18 18
4 12
9
0
0 0
1	1	1	1	1	1	1	1	1	1	1	1	1	1	1	1	1	1
1	1	1	1	1	1	1	1	1	1	1	1	1	1	1	1	1	1
1	1	1	1	1	1	1	1	1	1	1	1	1	1	1	1	1	1
1	1	1	1	16	16	16	16	16	16	16	16	16	16	16	1	1	1
1	1	1	1	16	17	17	17	17	17	17	17	17	17	16	1	1	1
1	1	1	1	16	17	17	17	17	17	17	17	17	17	16	1	1	1
1	1	1	1	16	17	17	17	17	17	17	17	17	17	16	1	1	1
1	1	1	1	16	14	14	14	14	14	14	14	14	14	16	1	1	1
1	1	1	1	16	14	14	14	14	14	14	14	14	14	16	1	1	1
1	1	1	1	17	14	14	14	14	14	14	14	14	14	16	1	1	1
1	1	1	1	17	14	14	14	14	14	14	14	14	14	16	1	1	1
1	1	1	1	17	14	14	14	14	14	14	14	14	14	16	1	1	1
1	1	1	0	14	14	14	14	14	14	14	14	14	14	16	1	1	1
1	1	1	1	16	14	14	14	14	14	14	14	14	14	16	1	1	1
1	1	1	1	16	16	16	16	16	16	16	16	16	16	16	1	1	1
1	1	1	1	1	1	1	1	1	1	1	1	1	1	1	1	1	1
1	1	1	1	1	1	1	1	1	1	1	1	1	1	1	1	1	1
1	1	1	1	1	1	1	1	1	1	1	1	1	1	1	1	1	1
42 3 12
100 8 8
99 8 9
99 9 8
99 9 9
99 10 8
99 10 9
99 11 8
99 11 9

