11 13
1 6
32
0
0 0
2   181 188 188 188 188 188 188 188 188 183 
2   186 170 170 170 170 170 170 170 170 186
2   186 176 176 176 176 176 176 176 176 186
2   186 91  91  91  91  91  91  91  91  186
2   186 91  91  91  91  91  91  91  91  186
2   170 91  91  91  91  91  91  91  91  186
2   176 29  91  91  91  91  91  91  91  186
1   28  32  91  91  91  91  91  91  91  186
2   186 35  91  91  91  91  91  91  91  186
2   186 91  91  91  91  91  91  91  91  186
2   186 91  91  91  91  91  91  91  91  186
2   186 91  91  91  91  91  91  91  91  186
2   187 188 188 188 188 188 188 188 188 189
35 0 7
66 5 5
67 5 6
67 6 5
67 6 6
67 7 5
67 7 6
67 8 5
67 8 6
90 4 1
106 2 2
106 3 2
106 5 2
106 6 2
106 8 2
106 9 2
106 8 11
106 9 11
106 2 5
106 3 5
91 6 4 
101 7 4
122 2 3
130 2 11
108 5 7
109 6 7
109 7 7
110 8 7
114 5 8
115 6 8
115 7 8
116 8 8
