18 18
13 9
3
4
0 0
1	1	1	1	1	1	1	1	1	1	1	1	1	1	1	1	1	1
1	1	1	1	1	1	1	1	1	1	1	1	1	1	1	1	1	1
1	1	1	1	1	1	1	1	1	1	1	1	1	1	1	1	1	1
1	1	1	16	16	16	16	16	16	16	16	16	16	16	1	1	1	1
1	1	1	16	17	16	17	16	17	17	17	17	17	16	1	1	1	1
1	1	1	16	17	16	17	16	17	17	17	17	17	16	1	1	1	1
1	1	1	16	17	16	17	16	17	17	17	17	17	17	1	1	1	1
1	1	1	16	3	17	3	17	3	3	3	3	3	17	1	1	1	1
1	1	1	16	3	17	3	17	3	3	3	3	3	17	1	1	1	1
1	1	1	16	3	17	3	17	3	3	3	3	3	3	0	1	1	1
1	1	1	16	3	3	3	3	3	3	3	3	3	16	1	1	1	1
1	1	1	16	3	3	3	3	3	3	3	3	3	16	1	1	1	1
1	1	1	16	3	3	3	3	3	3	3	3	3	16	1	1	1	1
1	1	1	16	3	3	3	3	3	3	3	3	3	16	1	1	1	1
1	1	1	16	16	16	16	16	16	16	16	16	16	16	1	1	1	1
1	1	1	1	1	1	1	1	1	1	1	1	1	1	1	1	1	1
1	1	1	1	1	1	1	1	1	1	1	1	1	1	1	1	1	1
1	1	1	1	1	1	1	1	1	1	1	1	1	1	1	1	1	1
39 14 9
120 6 7
121 11 7
58 288 160
58 320 160
59 128 192
59 192 192