28 37
24 8
24
7
3 1
1	1	1	1	1	1	1	1	1	1	1	1	1	1	1	1	1	1	1	1	1	1	1	1	1	1	1	1
1	1	1	1	1	1	1	1	1	1	1	1	1	1	1	1	1	1	1	1	1	1	1	1	1	1	1	1
1	1	1	1	1	1	1	1	1	1	1	1	1	1	1	1	1	1	1	1	1	1	1	1	1	1	1	1
1	1	1	1	1   16  16  16  16  16  16  16  16  16  16  16  16  16  16  16  16  16  16  16  16  1	1	1  
1	1	1	1	1   16  17  17  17  17  17  17  17  17  17  17  17  17  17  17  17  17  17  17  16  1	1	1  
1	1	1	1	1	16	17 	17 	17 	17 	17 	17 	17 	17 	17 	17	17 	17 	17 	17 	17 	17 	17 	17 	17 	1	1	1
1	1	1	1	1   16  17  17  17  17  17  17  17  17  17  17  17  17  17  17  17  17  17  17  17  1	1	1   
1	1	1	1   16  16  14  14  14  14  14  14  14  14  14  14  14  14  14  14  14  14  14  14  17  1	1	1   
1	1	1	1   17  17  14  14  14  14  14  14  14  14  14  14  14  14  14  14  14  14  14  14  14  0	1	1   
1	1	1	1   17 	17  14  14  14  14  14  14  14  14  14  14  14  14  14  14  14  14  14  14  16  1	1	1 
1	1	1   1   17 	17  14  14  14  14  16  16  16  16  16  16  14  14  14  14  14  14  14  14  16  1	1	1 
1	1	1	0   14	14	14	14  14  14  16  16  16  16  16  16  14  14  14  14  14  14  14  14  16  1	1	1  
1	1	1	1   16  16  16  14  14  14  16  16  16  16  16  16  14  14  14  14  14  14  14  14  16  1	1	1   
1	1	1	1   1	1	16  14  14  14  17  17  17  17  17  17  14  14  14  14  14  14  14  14  16  1   1   1   
1	1	1	1   1	1	16  14  14  14  17  17  17  17  17  17  14  14  14  14  14  14  14  14  16  1   1   1   
1	1	1	1   1	1	16  14  14  14  17  17  17  17  17  17  14  14  14  14  14  14  14  14  16  1   1   1   
1	1	1	1   1	1	16  14  14  14  14  14  14  14  14  14  14  14  14  14  14  14  14  14  16  1   1   1   
1	1	1	1   1	1	16  14  14  14  14  14  14  14  14  14  14  14  14  14  14  14  14  14  16  1   1   1   
1	1	1	1   1	1	16  14  14  14  14  14  14  14  14  14  14  14  14  14  14  14  14  14  16  1   1   1   
1	1	1	1   1	16  16  16  16  16  16  16  14  14  14  16  16  16  16  16  16  16  16  16  16  1   1   1   
1	1	1	1   1	16  17  17  17  17  17  17  14  14  14  16  17  17  17  17  17  17  17  16  1   1   1   1   
1	1	1	1	1	16	17 	17 	17 	17 	17 	17 	14	14	14	16  17  17  17  17  17  17  17  16  1   1   1   1   
1	1	1	1   1	16  17  17  17  17  17  17  14  14  14  17 	17 	17 	17 	17 	17 	17 	17 	16	1	1	1	1
1	1	1	1   16	16  14  14  14  14  14  14  14  14  14  17  14  14  14  14  14  14  14  16  1   1   1   1   
1	1	1	1   17 	17  14  14  14  14  14  14  14  14  14  17  14  14  14  14  14  14  14  16  1   1   1   1   
1	1	1	1   17  17  14  14  14  14  14  14  14  14  14  14  14  14  14  14  14  14  14  16  1   1   1   1   
1	1	1	1   17  17  14  14  14  14  14  14  14  14  14  14  14  14  14  14  14  14  14  16  1   1   1   1   
1	1	1   0   14  14  14  14  14  14  14  14  14  14  14  14  14  14  14  14  14  14  14  16  1   1   1   1   
1	1	1	1   16  16  16  16  16  16  16  16  16  16  16  16  14  14  14  14  14  14  14  16  1   1   1   1   
1	1	1	1   1	1	1	1	1   1	1	1	1	1   1	16  14  14  14  14  14  14  14  16  1   1   1   1   
1	1	1	1   1	1	1	1	1   1	1	1	1	1   1	16  14  14  14  14  14  14  14  16  1   1   1   1   
1	1	1	1   1	1	1	1	1   1	1	1	1	1   1	16  14  14  14  14  14  14  14  16  1   1   1   1   
1	1	1	1   1	1	1	1	1   1	1	1	1	1   1	16  14  14  14  14  14  14  14  16  1	1	1	1  
1	1	1	1   1	1	1	1	1   1	1	1	1	1   1	16  16  16  16  16  16  16  16  16  1	1	1	1   
1	1	1	1   1	1	1	1	1   1	1	1	1	1   1	1	1	1	1   1	1	1	1	1   1	1	1	1  
1	1	1	1   1	1	1	1	1   1	1	1	1	1   1	1	1	1	1   1	1	1	1	1   1	1	1	1  
1	1	1	1   1	1	1	1	1   1	1	1	1	1   1	1	1	1	1   1	1	1	1	1   1	1	1	1  
7 25 8
8 3 27
9 3 11
10 15 6
11 13 15
64 20 16
65 16 12
66 20 30
67 14 21
68 6 10
69 8 25
70 8 23
70 9 23
128 11 16
125 16 23
101 16 29
101 16 30
123 18 32
101 19 32
101 18 30
101 19 30
101 18 29
101 19 29
130 18 23
0 624 656
10 576 928
12 608 928
16 576 960
18 608 960
40 544 176
8 512 928
1 10
2 10
3 10
