39 43
7 20
48
10
1 5
1	1	1	1	1	1	1	1	1	1	1	1	1	1	1	1	1	1	1	1	1	1	1	1	1	1	1	1	1	1	1	1	1	1	1	1	1	1	1
1	1	1	1	1	1	1	1	1	1	1	1	1	1	1	1	1	1	1	1	1	1	1	1	1	1	1	1	1	1	1	1	1	1	1	1	1	1	1
1	1	1	1	1	1	1	1	1	1	1	1	1	1	1	1	1	1	1	1	1	1	1	1	1	1	1	1	1	1	1	1	1	1	1	1	1	1	1
1	1	1	1	1	1	1	1	1	1	1	1	1	16	16	16	16	16	16	16	16	16	16	16	1	1	1	1	1	1	1	1	1	1	1	1	1	1	1
1	1	1	1	1	1	1	1	1	1	1	1	1	16	17	17	17	17	17	17	17	17	17	16	1	1	1	1	1	1	1	1	1	1	1	1	1	1	1
1	1	1	1	1	1	1	1	1	1	1	1	1	16	17	17	17	17	17	17	17	17	17	16	1	1	1	1	1	1	1	1	1	1	1	1	1	1	1
1	1	1	1	1	1	1	1	1	1	1	1	1	16	17	17	17	17	17	17	17	17	17	16	1	1	1	1	1	1	1	1	1	1	1	1	1	1	1
1	1	1	1	16	16	16	16	16	16	16	16	16	16	14	14	14	14	14	14	14	14	14	16	16	16	16	16	16	16	16	16	1	1	1	1	1	1	1
1	1	1	1	16	17	17	17	17	17	17	17	17	17	14	14	14	14	14	14	14	14	14	17	17	17	17	17	17	17	17	17	1	1	1	1	1	1	1
1	1	1	1	17	17	17	17	17	17	17	17	17	17	14	14	14	14	14	14	14	14	14	17	17	17	17	17	17	17	17	17	1	1	1	1	1	1	1
1	1	1	1	17	17	17	17	17	17	17	17	17	17	14	14	14	14	14	14	14	14	14	17	17	17	0	17	17	17	17	17	1	1	1	1	1	1	1
1	1	1	1	17	14	14	14	14	14	14	14	14	14	14	14	14	14	14	14	14	14	14	14	14	14	14	14	14	14	0	1	1	1	1	1	1	1	1
1	1	1	0	14	14	14	14	14	14	14	14	14	14	14	14	14	14	14	14	14	14	14	14	14	14	14	14	14	16	16	16	16	16	16	16	1	1	1
1	1	1	1	16	14	14	14	14	14	14	14	14	14	14	14	14	14	14	14	14	14	14	14	14	14	14	14	14	17	17	17	17	17	17	16	1	1	1
1	1	1	1	16	14	14	14	14	14	14	14	14	14	14	14	14	14	14	14	14	14	14	14	14	14	14	14	14	17	17	17	17	17	17	16	1	1	1
1	1	1	1	16	14	14	14	14	14	14	14	14	14	14	14	14	14	14	14	14	14	14	14	14	14	14	14	14	17	17	17	17	17	17	16	1	1	1
1	1	1	1	16	14	14	14	14	14	14	14	14	14	14	14	14	14	14	14	14	14	14	14	14	14	14	14	14	14	14	14	14	14	14	16	1	1	1
1	1	1	1	16	16	14	14	14	16	16	16	16	16	16	16	16	14	14	14	16	16	16	16	16	14	14	14	14	14	14	14	14	14	14	16	1	1	1
1	1	1	1	1	16	18	18	18	16	1	1	1	1	1	1	16	14	14	14	16	1	1	1	16	14	14	14	14	14	14	14	14	14	14	16	1	1	1
1	1	1	1	1	16	18	18	18	16	1	1	1	1	1	1	16	14	14	14	16	1	1	1	16	14	14	14	14	14	14	14	14	14	14	16	1	1	1
1	1	1	1	1	16	18	18	18	16	1	1	1	1	1	1	16	14	14	14	16	1	1	1	16	14	14	14	14	14	14	14	14	14	14	16	1	1	1
1	1	1	1	1	16	0	0	0	16	1	1	1	1	16	16	16	14	14	14	16	16	16	1	16	16	16	16	16	16	14	14	14	14	14	16	1	1	1
1	1	1	1	1	1	1	1	1	1	1	1	1	1	17	17	17	14	14	14	17	17	17	1	1	1	1	1	1	16	14	14	14	14	14	16	1	1	1
1	1	1	1	1	1	1	1	1	1	1	1	1	1	17	17	17	14	14	14	17	17	17	1	1	1	1	1	1	16	14	14	14	14	14	16	1	1	1	
1	1	1	1	1	1	1	1	1	1	1	1	1	1	17	17	17	14	14	14	17	17	17	1	1	1	1	1	1	16	14	14	14	14	14	16	1	1	1	
1	1	1	1	1	1	1	1	1	1	1	1	1	0	14	14	14	14	14	14	14	14	14	0	1	1	1	1	1	16	14	14	14	14	14	16	1	1	1	
1	1	1	1	1	1	1	1	1	1	1	1	1	1	16	14	14	14	14	14	14	14	16	1	1	1	1	1	1	16	14	14	14	14	14	16	1	1	1	
1	1	1	1	1	1	1	1	1	1	1	1	1	1	16	14	14	14	14	14	14	14	16	1	1	1	1	1	1	16	14	14	14	14	14	16	1	1	1	
1	1	1	1	1	1	1	1	1	1	1	1	1	1	16	14	14	14	14	14	14	14	16	1	1	1	1	1	1	16	14	14	14	14	14	16	1	1	1	
1	1	1	1	1	1	1	1	1	1	1	1	1	1	16	16	16	16	16	16	16	16	16	1	1	1	1	16	16	16	14	14	14	14	14	16	1	1	1	
1	1	1	1	1	1	1	1	1	1	1	1	1	1	1	1	1	1	1	1	1	1	1	1	1	1	1	16	17	17	14	14	14	14	14	16	1	1	1	
1	1	1	1	1	1	1	1	1	1	1	1	1	1	1	1	1	1	1	1	1	1	1	1	1	1	1	16	17	17	14	14	14	14	14	16	1	1	1	
1	1	1	1	1	1	1	1	1	1	1	1	1	1	1	1	1	1	1	1	1	1	1	1	1	1	1	16	17	17	14	14	14	14	14	16	1	1	1	
1	1	1	1	1	1	1	1	1	1	1	1	1	1	1	1	1	1	1	1	1	1	1	1	1	1	1	16	14	14	14	14	14	16	16	16	1	1	1	
1	1	1	1	1	1	1	1	1	1	1	1	1	1	1	1	1	1	1	1	1	1	1	1	1	1	1	17	14	14	14	14	14	17	1	1	1	1	1	
1	1	1	1	1	1	1	1	1	1	1	1	1	1	1	1	1	1	1	1	1	1	1	1	1	1	1	17	14	14	14	14	14	17	1	1	1	1	1	
1	1	1	1	1	1	1	1	1	1	1	1	1	1	1	1	1	1	1	1	1	1	1	1	1	1	1	17	14	14	14	14	14	17	1	1	1	1	1	
1	1	1	1	1	1	1	1	1	1	1	1	1	1	1	1	1	1	1	1	1	1	1	1	1	1	0	14	14	14	14	14	14	14	0	1	1	1	1	
1	1	1	1	1	1	1	1	1	1	1	1	1	1	1	1	1	1	1	1	1	1	1	1	1	1	1	16	14	14	14	14	14	16	1	1	1	1	1	
1	1	1	1	1	1	1	1	1	1	1	1	1	1	1	1	1	1	1	1	1	1	1	1	1	1	1	16	16	16	16	16	16	16	1	1	1	1	1	
1	1	1	1	1	1	1	1	1	1	1	1	1	1	1	1	1	1	1	1	1	1	1	1	1	1	1	1	1	1	1	1	1	1	1	1	1	1	1
1	1	1	1	1	1	1	1	1	1	1	1	1	1	1	1	1	1	1	1	1	1	1	1	1	1	1	1	1	1	1	1	1	1	1	1	1	1	1
1	1	1	1	1	1	1	1	1	1	1	1	1	1	1	1	1	1	1	1	1	1	1	1	1	1	1	1	1	1	1	1	1	1	1	1	1	1	1
30 6 21
30 7 21
30 8 21
31 3 12
32 13 25
33 23 25
34 26 10
35 30 11
36 26 37
37 34 37
62 12 10
109 11 16
110 21 7
111 17 28
112 34 30
113 34 27
114 34 24
115 34 21
116 30 21
117 30 24
118 30 27
126 33 31
101 34 31
126 33 28
101 34 28
126 33 25
101 34 25
126 33 22
101 34 22
126 30 22
101 31 22
126 30 25
101 31 25
126 30 28
101 31 28
101 25 11
101 14 7
101 22 7
101 15 8
101 15 9
101 17 7
101 18 7
101 17 9
101 18 9
101 20 8
101 20 9
134 7 10
135 29 32
7 544 192
8 480 256
30 448 192
30 704 192
49 544 288
53 640 256
55 464 752
56 688 752
31 800 352
82 384 304
4 5
8 10
9 10
10 10
11 5