17 32
10 24
8
13
3 1
1	1	1	1	1	1	1	1	1	1	1	1	1	1	1	1	1
1	1	1	1	1	1	1	1	1	1	1	1	1	1	1	1	1
1	1	1	1	1	1	1	1	1	1	1	1	1	1	1	1	1
1	1	1	1	16	16	16	16	16	16	16	16	16	1	1	1	1
1	1	1	1	16	17	17	17	17	17	17	17	17	1	1	1	1
1	1	1	1	16	17	17	17	17	17	17	17	17	1	1	1	1
1	1	1	1	16	17	17	17	17	17	17	17	17	1	1	1	1
1	1	1	1	16	17	17	17	17	17	14	14	14	0	1	1	1
1	1	1	1	16	17	17	17	17	20	14	14	14	0	1	1	1
1	1	1	1	16	17	17	17	20	16	17	17	17	1	1	1	1
1	1	1	1	16	14	14	20	16	16	17	17	17	1	1	1	1
1	1	1	1	16	14	14	16	16	16	17	17	17	1	1	1	1
1	1	1	1	16	14	14	14	16	16	16	16	16	1	1	1	1
1	1	1	1   16	18	18	18	16	16	16 	16	16	1	1	1	1
1	1	1	1	17	18	18	18	17	17	17 	17	17	1	1	1	1
1	1	1	1	17	18	18	18	17	17	17	17	17	1	1	1	1
1	1	1	1	17	18	18	18	17  17	17 	17	17	1	1	1	1
1	1	1	0	14  14  14  14  14  14  14	14	14	0	1	1	1
1	1	1	1	16  14  14  14  14  14  16 	16	16	1	1	1	1
1	1	1	1	16  14  14  14  14  14  16 	1	1	1	1	1	1
1	1	1	1	16  14  14  14  14  14	16 	1	1	1	1	1	1
1	1	1	1	17	14  14  14  14  14  17	1	1	1	1	1	1
1	1	1	1	17	14  14  14  14  14  17	1	1	1	1	1	1
1	1	1	1	17	14  14  14  14  14  17	1	1	1	1	1	1
1	1	1	0	14  14  14  14  14  14  14	0	1	1	1	1	1
1	1	1	1	16  14  14  14  14  14  16 	1	1	1	1	1	1
1	1	1	1	16  14  14  14  14  14  16 	1	1	1	1	1	1
1	1	1	1	16  16	16  14  14  14  16 	1	1	1	1	1	1
1	1	1	1	1	1	16	16	16	16	16	1	1	1	1	1	1
1	1	1	1	1	1	1	1	1	1	1	1	1	1	1	1	1
1	1	1	1	1	1	1	1	1	1	1	1	1	1	1	1	1
1	1	1	1	1	1	1	1	1	1	1	1	1	1	1	1	1
18 11 24
19 13 17
20 3 24
21 3 17
23 13 7
23 13 8
60 9 16
96 5 26
32 288 224
32 256 256
32 224 288
33 288 256
33 256 288
33 224 320
34 288 288
34 256 320
34 224 352
35 256 352
35 288 352
35 288 320
80 288 496
4 5
9 10
12 10