28 35
24 7
0
0
0 0
2   2   2   2   2   2   2   2   2   2   2   2   2   2   2   2   2   2   2   2   2   2   2   2   2   2   2   2   
2   2   2   2   2   2   2   2   2   2   2   2   2   2   2   2   2   2   2   2   2   2   2   2   2   2   2   2   
2   2   2   2   2   2   2   2   2   2   2   2   2   2   2   2   2   2   2   2   2   2   2   2   2   2   2   2   
2   2   2   2   2   181 188 188 188 188 188 188 188 188 188 1   188 188 188 188 188 188 188 188 183 2   2   2   
2   2   2   2   2   186 170 170 170 170 170 170 170 170 170 58  170 170 170 170 170 170 170 170 184 2   2   2   
2   2   2   2   2   186 176 176 176 176 176 176 176 176 176 58  176 176 176 176 176 176 176 176 170 2   2   2   
2   2   2   2   187 189 58  58  58  58  58  58  58  58  58  58  58  58  58  58  58  58  58  58  176 2   2   2   
2   2   2   2   170 170 58  58  58  58  58  58  58  58  58  58  58  58  58  58  58  58  58  58  58  1   2   2   
2   2   2   2   176 176 58  58  58  58  58  58  58  58  58  58  58  58  58  58  58  58  58  58  186 2   2   2   
2   2   2   1   58  58  58  58  58  58  181 182 182 182 182 183 58  58  58  58  58  58  58  58  184 2   2   2   
2   2   2   2   182 182 183 58  58  58  184 185 185 185 185 186 58  58  58  58  58  58  58  58  184 2   2   2   
2   2   2   2   2   2   186 58  58  58  184 185 185 185 185 186 58  58  58  58  58  58  58  58  184 2   2   2   
2   2   2   2   2   2   186 58  58  58  187 188 188 188 188 189 58  58  58  58  58  58  58  58  184 2   2   2   
2   2   2   2   2   2   186 58  58  58  170 170 170 170 170 170 58  58  58  58  58  58  58  58  184 2   2   2   
2   2   2   2   2   2   186 58  58  58  176 176 176 1   176 176 58  58  58  58  58  58  58  58  184 2   2   2   
2   2   2   2   2   2   186 58  58  58  58  58  58  58  58  58  58  58  58  58  58  58  58  58  184 2   2   2   
2   2   2   2   2   2   186 58  58  58  58  58  58  58  58  58  58  58  58  58  58  58  58  58  184 2   2   2   
2   2   2   2   2   2   186 58  58  58  58  58  58  58  58  58  58  58  58  58  58  58  58  58  184 2   2   2   
2   2   2   2   2   181 189 188 188 188 188 188 58  58  58  186 188 188 188 188 188 188 188 185 189 2   2   2   
2   2   2   2   2   186 170 170 170 170 170 170 58  58  58  184 170 170 170 170 170 170 170 184 2   2   2   2   
2   2   2   2   2   186 176 176 176 176 176 176 58  58  58  187 176 176 176 176 176 176 176 184 2   2   2   2   
2   2   2   2   2   186 58  58  58  58  58  58  58  58  58  170 58  58  58  58  58  58  58  184 2   2   2   2   
2   2   2   2   188 189 58  58  58  58  58  58  58  58  58  176 58  58  58  58  58  58  58  184 2   2   2   2   
2   2   2   2   170 170 58  58  58  58  58  58  58  58  58  58  58  58  58  58  58  58  58  184 2   2   2   2   
2   2   2   2   176 176 58  58  58  58  58  58  58  58  58  58  58  58  58  58  58  58  58  184 2   2   2   2   
2   2   2   1   58  58  58  58  58  58  58  58  58  58  58  58  58  58  58  58  58  58  58  184 2   2   2   2   
2   2   2   2   181 183 58  58  58  58  58  58  58  58  58  184 58  58  58  58  58  58  58  184 2   2   2   2   
2   2   2   2   2   186 58  58  58  58  58  58  58  58  58  184 58  58  58  58  58  58  58  184 2   2   2   2   
2   2   2   2   2   186 58  58  58  58  58  58  58  58  58  184 58  58  58  58  58  58  58  184 2   2   2   2   
2   2   2   2   2   187 188 188 188 188 188 188 188 188 188 185 58  58  58  58  58  58  58  184 2   2   2   2   
2   2   2   2   2   2   2   2   2   2   2   2   2   2   2   186 58  58  58  58  58  58  58  184 2   2   2   2   
2   2   2   2   2   2   2   2   2   2   2   2   2   2   2   187 188 188 188 188 188 188 188 189 2   2   2   2    
2   2   2   2   2   2   2   2   2   2   2   2   2   2   2   2   2   2   2   2   2   2   2   2   2   2   2   2   
2   2   2   2   2   2   2   2   2   2   2   2   2   2   2   2   2   2   2   2   2   2   2   2   2   2   2   2   
2   2   2   2   2   2   2   2   2   2   2   2   2   2   2   2   2   2   2   2   2   2   2   2   2   2   2   2   


1 10
2 10
3 10

