45 32
15 19
20
23
0 0
1	1	1	1	1	1	1	1	1	1	1	1	1	1	1	1	1	1	1	1	1	1	1	1	1	1	1	1	1	1	1	1	1	1	1	1	1	1	1	1	1	1	1	1	1
1	1	1	1	1	1	1	1	1	1	1	1	1	1	1	1	1	1	1	1	1	1	1	1	1	1	1	1	1	1	1	1	1	1	1	1	1	1	1	1	1	1	1	1	1
1	1	1	1	1	1	1	1	1	1	1	1	1	1	1	1	1	1	1	1	1	1	1	1	1	1	1	1	1	1	1	1	1	1	1	1	1	1	1	1	1	1	1	1	1
1	1	1	29	29	29	29	29	29	29	29	29	29	29	29	29	29	29	29	29	29	29	29	29	29	29	17	17	17	17	17	17	17	29	29	29	29	29	29	29	29	29	1	1	1
1	1	1	29	29	29	29	29	29	29	29	29	29	29	29	29	29	29	29	29	29	29	29	29	29	29	17	17	17	17	17	17	17	29	29	29	29	29	29	29	29	29	1	1	1
1	1	1	29	29	29	29	29	29	29	29	29	29	29	29	29	29	29	29	29	29	29	29	29	29	29	17	17	17	17	17	17	17	29	29	29	29	29	29	29	29	29	1	1	1
1	1	1	29	29	29	29	29	29	29	29	29	29	29	29	29	29	29	29	29	29	29	29	29	29	29	17	17	17	17	17	17	17	29	29	29	29	29	29	29	29	29	1	1	1
1	1	1	29	29	29	29	29	29	29	29	29	29	29	29	29	29	29	29	29	29	29	29	29	29	29	17	17	17	17	17	17	17	29	29	29	29	29	29	29	29	29	1	1	1
1	1	1	29	29	29	29	29	29	29	29	29	29	29	29	29	29	29	29	29	29	29	29	29	29	29	17	17	1	1	1	17	17	29	29	29	29	29	29	29	29	29	1	1	1
1	1	1	29	29	29	29	16	16	16	16	16	16	16	16	29	29	29	29	29	29	29	29	29	29	29	17	17	0	0	0	17	17	29	29	29	29	29	29	29	29	29	1	1	1
1	1	1	29	29	29	29	16	16	16	16	16	16	16	16	29	29	29	29	29	29	29	29	29	29	29	29	25	19	19	19	25	29	29	29	29	29	29	29	29	29	29	1	1	1
1	1	1	29	29	29	29	16	16	16	16	16	16	16	16	29	29	29	29	29	29	29	29	29	29	29	29	25	19	19	19	25	29	29	29	29	29	29	29	29	29	29	1	1	1
1	1	1	29	29	29	29	16	16	16	16	16	16	16	16	29	29	29	29	29	29	29	29	29	29	29	29	25	25	25	25	25	29	29	29	29	29	29	29	29	29	29	1	1	1
1	1	1	29	29	29	29	16	16	16	16	16	16	16	16	29	29	29	29	29	29	29	29	29	29	29	29	25	25	25	25	25	29	29	29	29	29	29	29	29	29	29	1	1	1
1	1	1	29	29	29	29	17	17	17	17	17	17	17	17	29	29	29	29	29	29	29	29	29	29	29	29	25	25	25	25	25	29	29	29	29	29	29	29	29	29	29	1	1	1
1	1	1	29	29	29	29	17	17	17	17	17	17	17	17	29	29	29	29	29	29	29	29	29	29	29	29	25	25	25	25	25	29	29	29	29	29	29	29	29	29	29	1	1	1
1	1	1	29	29	29	29	17	17	17	17	17	17	17	17	29	29	29	29	29	29	29	29	29	29	29	29	25	25	25	25	25	29	29	29	29	29	29	29	29	29	29	1	1	1
1	1	1	29	29	29	29	17	17	17	17	17	17	17	17	25	25	25	25	25	25	25	25	25	25	25	25	25	25	25	25	25	29	29	29	29	29	29	29	29	29	29	1	1	1
1	1	1	29	29	29	29	17	17	17	17	17	17	17	17	25	25	25	25	25	25	25	25	25	25	25	25	25	25	25	25	25	29	29	29	29	29	29	29	29	29	29	1	1	1
1	1	1	29	29	29	29	17	17	17	17	17	17	17	17	25	25	25	25	25	25	25	25	25	25	25	25	25	25	25	25	25	29	29	29	29	29	29	29	29	29	29	1	1	1
1	1	1	29	29	29	29	17	17	17	17	17	17	17	17	25	25	25	25	25	25	25	25	25	25	25	25	25	25	25	25	25	29	29	29	29	29	29	29	29	29	29	1	1	1
1	1	1	29	29	29	29	17	17	17	17	17	17	17	17	25	25	25	25	25	25	25	25	25	25	25	25	25	25	25	25	25	29	29	29	29	29	29	29	29	29	29	1	1	1
1	1	1	29	29	29	29	17	17	17	17	17	17	17	17	29	29	29	29	29	29	29	29	29	29	29	29	29	29	29	29	29	29	29	29	29	29	29	29	29	29	29	1	1	1
1	1	1	29	29	29	29	17	17	17	17	17	17	17	17	29	29	29	29	29	29	29	29	29	29	29	29	29	29	29	29	29	29	29	29	29	29	29	29	29	29	29	1	1	1
1	1	1	29	29	29	29	17	17	17	17	17	17	17	17	29	29	29	29	29	29	29	29	29	29	29	29	29	29	29	29	29	29	29	29	29	29	29	29	29	29	29	1	1	1
1	1	1	29	29	29	29	17	17	17	17	17	17	17	17	29	29	29	29	29	29	29	29	29	29	29	29	29	29	29	29	29	29	29	29	29	29	29	29	29	29	29	1	1	1
1	1	1	29	29	29	29	17	17	17	17	17	17	17	17	29	29	29	29	29	29	29	29	29	29	29	29	29	29	29	29	29	29	29	29	29	29	29	29	29	29	29	1	1	1
1	1	1	29	29	29	29	17	17	17	17	17	17	17	17	29	29	29	29	29	29	29	29	29	29	29	29	29	29	29	29	29	29	29	29	29	29	29	29	29	29	29	1	1	1
1	1	1	29	29	29	29	17	17	17	17	17	17	17	17	29	29	29	29	29	29	29	29	29	29	29	29	29	29	29	29	29	29	29	29	29	29	29	29	29	29	29	1	1	1
1	1	1	1	1	1	1	1	1	1	1	1	1	1	1	1	1	1	1	1	1	1	1	1	1	1	1	1	1	1	1	1	1	1	1	1	1	1	1	1	1	1	1	1	1
1	1	1	1	1	1	1	1	1	1	1	1	1	1	1	1	1	1	1	1	1	1	1	1	1	1	1	1	1	1	1	1	1	1	1	1	1	1	1	1	1	1	1	1	1
1	1	1	1	1	1	1	1	1	1	1	1	1	1	1	1	1	1	1	1	1	1	1	1	1	1	1	1	1	1	1	1	1	1	1	1	1	1	1	1	1	1	1	1	1
28 14 17
28 14 18
28 14 19
28 14 20
28 14 21
29 28 9
29 29 9
29 30 9
63 21 17
101 15 17
101 16 17
101 17 17
101 18 17
101 19 17
101 20 17
101 22 17
101 23 17
101 24 17
101 25 17
101 26 17
61 832 224
62 832 256
62 832 352
62 832 448
65 480 512
65 576 512
65 672 512
65 768 512
67 832 536
83 480 544
84 496 544
84 528 544
84 560 544
84 592 544
84 624 544
85 656 544
83 704 544
84 720 544
84 752 544
84 784 544
84 816 544
85 848 544
71 0 0