27 34
22 21
15
0
0 0
1	1	1	1	1	1	1	1	1	1	1	1	1	1	1	1	1	1	1	1	1	1	1	1	1	1	1
1	1	1	1	1	1	1	1	1	1	1	1	1	1	1	1	1	1	1	1	1	1	1	1	1	1	1
1	1	1	1	1	1	1	1	1	1	1	1	1	1	1	1	1	1	1	1	1	1	1	1	1	1	1
1	1	1	1	1	1	1	1	1	1	1	1	1	1	1	1	1	1	1	1	1	1	1	1	1	1	1
1	1	1	1	1	16  16  16  16  16  16  16  16  16  16  16  16  16  16  16  16  16 	1	1	1	1	1
1	1	1	1	1	16  17  17  17  17  17  17  17  17  17  17  17  17  17  17  17  16  1	1	1	1	1
1	1	1	1	1	16  17  17  17  17  17  17  17  17  17  17  17  17  17  17  17  16  1	1	1	1	1		
1	1	1	1	1	16  17  17  17  17  17  17  17  17  17  17  17  17  17  17  17  16  1	1	1	1	1
1	1	1	1	1	16  14  14  14  14  14  14  14  14  14  14  14  14  14  14  14  16  1	1	1	1	1	
1	1	1	1	1	16  14  14  14  14  14  14  14  14  14  14  14  14  14  14  14  16  1	1	1	1	1	
1	1	1	1	1	16  14  14  14  14  14  14  14  16  14  14  14  14  14  14  14  16  1	1	1	1	1	
1	1	1	1	1	16  14  14  14  14  14  14  14  16  14  14  14  14  14  14  14  16  1	1	1	1	1	
1	1	1	1	1	16  14  14  14  14  14  14  14  16  14  14  14  14  14  14  14  16  1	1	1	1	1	
1	1	1	1	1	16  14  14  14  14  14  14  14  16  14  14  14  14  14  14  14  16  1	1	1	1	1	
1	1	1	1	1	16  14  14  14  14  14  14  14  16  14  14  14  14  14  14  14  16  1	1	1	1	1	
1	1	1	1	1	16  14  14  14  14  14  14  14  16  14  14  14  14  14  14  14  16  1	1	1	1	1	
1	1	1	1	1	16  16  16  14  14  14  14  14  16  14  14  14  14  14  16  16  16  1	1	1	1	1	
1	1	1	1	16  16  17  17  14  14  14  14  14  16  14  14  14  14  14  17  17  16  16  1	1	1	1
1	1	1	1	17  17  14  14  14  14  14  14  14  16  14  14  14  14  14  14  14  17  17  1	1	1	1
1	1	1	1	17  17  14  14  14  14  14  14  14  16  14  14  14  14  14  14  14  17  17  1	1	1	1
1	1	1	1	17  17  14  14  14  14  14  16  16  16  16  16  14  14  14  14  14  17  17  1	1	1	1
1	1	1	0	14  14  14  14  14  14  14  17  17  17  17  17  14  14  14  14  14  14  14  0	1	1	1
1	1	1	1	16  16  14  14  14  14  14  14  14  14  14  14  14  14  14  14  14  16  16  1	1	1	1
1	1	1	1	1	16  14  14  14  14  14  14  14  14  14  14  14  14  14  14  14  16  1	1	1	1	1	
1	1	1	1	1	16  14  14  14  14  14  14  14  14  14  14  14  14  14  14  14  16  1	1	1	1	1	
1	1	1	1	1	16  16  16  14  14  14  14  14  16  14  14  14  14  14  16  16  16  1	1	1	1	1	
1	1	1	1	1	16  17  17  14  14  14  14	14  16  14  14  14  14  14  17  17  16  1	1	1	1	1	
1	1	1	1	1	16  14  14  14  14  14  14	14  16  14  14  14  14  14  14  14  16  1	1	1	1	1	
1	1	1	1	1	16  14  14  14  14  14  14	14	16  14  14  14  14  14  14  14  16  1	1	1	1	1	
1	1	1	1	1	16  16  16  16  16  16  16  16  16  16  16  16  16  16  16  16  16  1	1	1	1	1	
1	1	1	1	1	1	1	1	1	1	1	1	1	1	1	1	1	1	1	1	1	1	1	1	1	1	1
1	1	1	1	1	1	1	1	1	1	1	1	1	1	1	1	1	1	1	1	1	1	1	1	1	1	1
1	1	1	1	1	1	1	1	1	1	1	1	1	1	1	1	1	1	1	1	1	1	1	1	1	1	1
1	1	1	1	1	1	1	1	1	1	1	1	1	1	1	1	1	1	1	1	1	1	1	1	1	1	1
12 3 21
13 23 21
82 14 18
83 14 14
84 14 10
85 20 14
86 20 10
87 12 18
88 12 14
89 12 10
90 6 14
91 6 10
92 20 27
94 11 27
95 6 18