20 7
5 8
3
0 0
2   181 188 188 188 188 188 188 188 188 188 188 188 188 188 188 188 188 181 2
2   188 170 170 170 170 170 170 170 170 170 170 170 170 170 170 170 170 188 2
2   170 176 176 176 176 176 176 176 176 176 176 176 176 176 176 176 176 170 2
2   176 91  91  91  91  91  91  91  91  91  91  91  91  91  91  91  91  176 2
1   91  91  91  91  91  91  91  91  91  91  91  91  91  91  91  91  91  91  1
2   181 91  91  91  91  91  91  91  91  91  91  91  91  91  91  91  91  181 2
2   182 182 182 182 182 182 182 182 182 182 182 182 182 182 182 182 182 182 2
16 19 4
37 0 4
76 4 3

