27 34
22 21
47
8
1.2 4
1	1	1	1	1	1	1	1	1	1	1	1	1	1	1	1	1	1	1	1	1	1	1	1	1	1	1
1	1	1	1	1	1	1	1	1	1	1	1	1	1	1	1	1	1	1	1	1	1	1	1	1	1	1
1	1	1	1	1	1	1	1	1	1	1	1	1	1	1	1	1	1	1	1	1	1	1	1	1	1	1
1	1	1	1	1	1	1	1	1	1	1	1	1	1	1	1	1	1	1	1	1	1	1	1	1	1	1
1	1	1	1	1	16  16  16  16  16  16  16  16  16  16  16  16  16  16  16  16  16 	1	1	1	1	1
1	1	1	1	1	16  17  17  17  17  17  17  17  17  17  17  17  17  17  17  17  16  1	1	1	1	1
1	1	1	1	1	16  17  17  17  17  17  17  17  17  17  17  17  17  17  17  17  16  1	1	1	1	1		
1	1	1	1	1	16  17  17  17  17  17  17  17  17  17  17  17  17  17  17  17  16  1	1	1	1	1
1	1	1	1	1	16  14  14  14  14  14  14  14  14  14  14  14  14  14  14  14  16  1	1	1	1	1	
1	1	1	1	1	16  14  14  14  14  14  14  14  14  14  14  14  14  14  14  14  16  1	1	1	1	1	
1	1	1	1	1	16  14  14  14  14  14  14  14  16  14  14  14  14  14  14  14  16  1	1	1	1	1	
1	1	1	1	1	16  14  14  14  14  14  14  14  16  14  14  14  14  14  14  14  16  1	1	1	1	1	
1	1	1	1	1	16  14  14  14  14  14  14  14  16  14  14  14  14  14  14  14  16  1	1	1	1	1	
1	1	1	1	1	16  14  14  14  14  14  14  14  16  14  14  14  14  14  14  14  16  1	1	1	1	1	
1	1	1	1	1	16  14  14  14  14  14  14  14  16  14  14  14  14  14  14  14  16  1	1	1	1	1	
1	1	1	1	1	16  14  14  14  14  14  14  14  16  14  14  14  14  14  14  14  16  1	1	1	1	1	
1	1	1	1	1	16  16  16  14  14  14  14  14  16  14  14  14  14  14  16  16  16  1	1	1	1	1	
1	1	1	1	16  16  17  17  14  14  14  14  14  16  14  14  14  14  14  17  17  16  16  1	1	1	1
1	1	1	1	17  17  14  14  14  14  14  14  14  16  14  14  14  14  14  14  14  17  17  1	1	1	1
1	1	1	1	17  17  14  14  14  14  14  14  14  16  14  14  14  14  14  14  14  17  17  1	1	1	1
1	1	1	1	17  17  14  14  14  14  14  16  16  16  16  16  14  14  14  14  14  17  17  1	1	1	1
1	1	1	0	14  14  14  14  14  14  14  17  17  17  17  17  14  14  14  14  14  14  14  0	1	1	1
1	1	1	1	16  16  14  14  14  14  14  14  14  14  14  14  14  14  14  14  14  16  16  1	1	1	1
1	1	1	1	1	16  14  14  14  14  14  14  14  14  14  14  14  14  14  14  14  16  1	1	1	1	1	
1	1	1	1	1	16  14  14  14  14  14  14  14  14  14  14  14  14  14  14  14  16  1	1	1	1	1	
1	1	1	1	1	16  16  16  14  14  14  14  14  16  14  14  14  14  14  14  14  16  1	1	1	1	1	
1	1	1	1	1	16  17  17  14  14  14  14	14  16  14  14  14  14  14  14  14  16  1	1	1	1	1	
1	1	1	1	1	16  14  14  14  14  14  14	14  16  14  14  14  14  14  14  14  16  1	1	1	1	1	
1	1	1	1	1	16  14  14  14  14  14  14	14	16  14  14  14  14  14  14  14  16  1	1	1	1	1	
1	1	1	1	1	16  16  16  16  16  16  16  16  16  16  16  16  16  16  16  16  16  1	1	1	1	1	
1	1	1	1	1	1	1	1	1	1	1	1	1	1	1	1	1	1	1	1	1	1	1	1	1	1	1
1	1	1	1	1	1	1	1	1	1	1	1	1	1	1	1	1	1	1	1	1	1	1	1	1	1	1
1	1	1	1	1	1	1	1	1	1	1	1	1	1	1	1	1	1	1	1	1	1	1	1	1	1	1
1	1	1	1	1	1	1	1	1	1	1	1	1	1	1	1	1	1	1	1	1	1	1	1	1	1	1
12 3 21
13 23 21
82 14 18
83 14 14
84 14 10
85 19 14
86 19 10
87 11 18
88 11 14
89 11 10
90 6 14
91 6 10
92 19 27
93 7 18
94 11 27
95 6 18
126 14 19
101 15 19
126 14 15
101 15 15
126 14 11
101 15 11
126 19 15
101 20 15
126 19 11
101 20 11
126 11 19
101 12 19
126 11 15
101 12 15
126 11 11
101 12 11
126 6 15
101 7 15
126 6 11
101 7 11
127 11 26
101 12 26
127 19 26
101 20 26
101 6 8
101 7 8
101 8 8
101 18 8
101 19 8
101 20 8
131 11 8
0 576 176
47 192 224
47 224 224
47 256 224
47 576 224
47 608 224
47 640 224
78 352 864
1 10
2 10
6 10
11 5
1