17 33
10 25
0
0
0 0
1	1	1	1	1	1	1	1	1	1	1	1	1	1	1	1	1
1	1	1	1	1	1	1	1	1	1	1	1	1	1	1	1	1
1	1	1	1	1	1	1	1	1	1	1	1	1	1	1	1	1
1	1	1	1	16	16	16	16	16	16	16	16	16	1	1	1	1
1	1	1	1	16	17	17	17	17	17	17	17	17	1	1	1	1
1	1	1	1	16	17	17	17	17	17	17	17	17	1	1	1	1
1	1	1	1	16	17	17	17	17	17	17	17	17	1	1	1	1
1	1	1	1	16	17	17	17	17	14	14	14	14	0	1	1	1
1	1	1	1	16	17	17	17	14	14	14	14	14	0	1	1	1
1	1	1	1	16	14	14	14	14	14	14	14	14	0	1	1	1
1	1	1	1	16	14	14	14	14	17	17	17	17	1	1	1	1
1	1	1	1	16	14	14	14	16	17	17	1	1	1	1	1	1
1	1	1	1   16 	14	14	14	16	16	16 	1	1	1	1	1	1
1	1	1	1	17 	14	14	14	17	17	17 	1	1	1	1	1	1
1	1	1	1	17  14	14	14	17	17	17	1	1	1	1	1	1
1	1	1	1	17  14  14  14  17  17	17 	1	1	1	1	1	1
1	1	1	0	14  14  14  14  14  14  14	0	1	1	1	1	1
1	1	1	1	16  14  14  14  14  14  16 	1	1	1	1	1	1
1	1	1	1	16  14  14  14  14  14  16 	1	1	1	1	1	1
1	1	1	1	16  14  14  14  14  14	16 	1	1	1	1	1	1
1	1	1	1	17	14  14  14  14  14  17	1	1	1	1	1	1
1	1	1	1	17	14  14  14  14  14  17	1	1	1	1	1	1
1	1	1	1	17	14  14  14  14  14  17	1	1	1	1	1	1
1	1	1	0	14  14  14  14  14  14  14	0	1	1	1	1	1
1	1	1	1	16  14  14  14  14  14  16 	1	1	1	1	1	1
1	1	1	1	16  14  14  14  14  14  16 	1	1	1	1	1	1
1	1	1	1	16  16	16  14  14  14  16 	1	1	1	1	1	1
1	1	1	1	1	1	16	0	0	0	16	1	1	1	1	1	1
1	1	1	1	1	1	16	1	1	1	16	1	1	1	1	1	1
1	1	1	1	1	1	16	1	1	1	16	1	1	1	1	1	1
1	1	1	1	1	1	1	1	1	1	1	1	1	1	1	1	1
1	1	1	1	1	1	1	1	1	1	1	1	1	1	1	1	1
1	1	1	1	1	1	1	1	1	1	1	1	1	1	1	1	1

