28 37
24 8
11
0
0 0
1	1	1	1	1	1	1	1	1	1	1	1	1	1	1	1	1	1	1	1	1	1	1	1	1	1	1	1
1	1	1	1	1	1	1	1	1	1	1	1	1	1	1	1	1	1	1	1	1	1	1	1	1	1	1	1
1	1	1	1	1	1	1	1	1	1	1	1	1	1	1	1	1	1	1	1	1	1	1	1	1	1	1	1
1	1	1	1	1   16  16  16  16  16  16  16  16  16  16  16  16  16  16  16  16  16  16  16  16  1	1	1  
1	1	1	1	1   16  17  17  17  17  17  17  17  17  17  0   17  17  17  17  17  17  17  17  16  1	1	1  
1	1	1	1	1	16	17 	17 	17 	17 	17 	17 	17 	17 	17 	14	17 	17 	17 	17 	17 	17 	17 	17 	17 	1	1	1
1	1	1	1	1   16  17  17  17  17  17  17  17  17  17  14  17  17  17  17  17  17  17  17  17  1	1	1   
1	1	1	1   16  16  14  14  14  14  14  14  14  14  14  14  14  14  14  14  14  14  14  14  17  1	1	1   
1	1	1	1   17  17  14  14  14  14  14  14  14  14  14  14  14  14  14  14  14  14  14  14  14  0	1	1   
1	1	1	1   17 	17  14  14  14  14  14  14  14  14  14  14  14  14  14  14  14  14  14  14  16  1	1	1 
1	1	1   1   17 	17  14  14  14  14  16  16  16  16  16  16  14  14  14  14  14  14  14  14  16  1	1	1 
1	1	1	0   14	14	14	14  14  14  16  16  16  16  16  16  14  14  14  14  14  14  14  14  16  1	1	1  
1	1	1	1   16  16  16  14  14  14  16  16  16  16  16  16  14  14  14  14  14  14  14  14  16  1	1	1   
1	1	1	1   1	1	16  14  14  14  17  17  17  17  17  17  14  14  14  14  14  14  14  14  16  1   1   1   
1	1	1	1   1	1	16  14  14  14  17  17  17  17  17  17  14  14  14  14  14  14  14  14  16  1   1   1   
1	1	1	1   1	1	16  14  14  14  17  17  17  17  17  17  14  14  14  14  14  14  14  14  16  1   1   1   
1	1	1	1   1	1	16  14  14  14  14  14  14  14  14  14  14  14  14  14  14  14  14  14  16  1   1   1   
1	1	1	1   1	1	16  14  14  14  14  14  14  14  14  14  14  14  14  14  14  14  14  14  16  1   1   1   
1	1	1	1   1	1	16  14  14  14  14  14  14  14  14  14  14  14  14  14  14  14  14  14  16  1   1   1   
1	1	1	1   1	16  16  16  16  16  16  16  14  14  14  16  16  16  16  16  16  16  16  16  16  1   1   1   
1	1	1	1   1	16  17  17  17  17  17  17  14  14  14  16  17  17  17  17  17  17  17  16  1   1   1   1   
1	1	1	1	1	16	17 	17 	17 	17 	17 	17 	14	14	14	16  17  17  17  17  17  17  17  16  1   1   1   1   
1	1	1	1   1	16  17  17  17  17  17  17  14  14  14  17 	17 	17 	17 	17 	17 	17 	17 	16	1	1	1	1
1	1	1	1   16	16  14  14  14  14  14  14  14  14  14  17  14  14  14  14  14  14  14  16  1   1   1   1   
1	1	1	1   17 	17  14  14  14  14  14  14  14  14  14  17  14  14  14  14  14  14  14  16  1   1   1   1   
1	1	1	1   17  17  14  14  14  14  14  14  14  14  14  14  14  14  14  14  14  14  14  16  1   1   1   1   
1	1	1	1   17  17  14  14  14  14  14  14  14  14  14  14  14  14  14  14  14  14  14  16  1   1   1   1   
1	1	1   0   14  14  14  14  14  14  14  14  14  14  14  14  14  14  14  14  14  14  14  16  1   1   1   1   
1	1	1	1   16  16  14  14  14  14  14  14  14  14  14  16  14  14  14  14  14  14  14  16  1   1   1   1   
1	1	1	1   1	16  14  14  14  14  14  14  14  14  14  16  14  14  14  14  14  14  14  16  1   1   1   1   
1	1	1	1   1	16  14  14  14  14  14  14  14  14  14  16  14  14  14  14  14  14  14  16  1   1   1   1   
1	1	1	1   1	16  16  16  16  16  16  16  16  16  16  16  14  14  14  14  14  14  14  16  1   1   1   1   
1	1	1	1   1	1	1	1	1   1	1	1	1	1   1	16  14  14  14  14  14  14  14  16  1	1	1	1  
1	1	1	1   1	1	1	1	1   1	1	1	1	1   1	16  16  16  16  16  16  16  16  16  1	1	1	1   
1	1	1	1   1	1	1	1	1   1	1	1	1	1   1	1	1	1	1   1	1	1	1	1   1	1	1	1  
1	1	1	1   1	1	1	1	1   1	1	1	1	1   1	1	1	1	1   1	1	1	1	1   1	1	1	1  
1	1	1	1   1	1	1	1	1   1	1	1	1	1   1	1	1	1	1   1	1	1	1	1   1	1	1	1  
7 25 8
8 3 27
9 3 11
10 15 4
11 13 15
64 20 16
65 16 12
66 20 30
67 14 21
68 6 10
69 8 25
