30 36
6 9
34
0 0
2   181 188 188 188 188 188 188 188 183 2   2   2   2   2   2   2   2   2   2   181 188 188 188 188 188 188 188 188 183
2   186 170 170 170 170 170 170 170 186 2   2   2   2   2   2   2   2   2   2   186 170 170 170 170 170 170 170 170 186
2   186 176 176 176 176 176 176 176 186 2   2   2   2   2   2   2   2   2   2   186 176 176 176 176 176 176 176 176 186
2   186 49  50  50  50  50  50  51  186 2   2   2   2   2   2   2   2   2   2   186 91  91  91  91  91  91  91  91  186
2   186 52  53  53  53  53  53  54  186 2   2   2   2   2   2   2   2   2   2   186 91  91  91  91  91  91  91  91  186
2   186 52  53  53  53  53  53  54  170 2   2   2   2   2   2   2   2   2   2   170 91  91  91  91  91  91  91  91  186
2   186 52  53  53  53  53  53  54  176 2   2   2   2   2   2   2   2   2   2   176 91  91  91  91  91  91  91  91  186
2   186 52  53  53  53  53  53  53  54  1   2   2   2   2   2   2   2   2   1   91  91  91  91  91  91  91  91  91  186
2   186 52  53  53  53  53  53  54  186 2   2   2   2   2   2   2   2   2   2   186 91  91  91  91  91  91  91  91  186
2   186 55  56  56  56  56  56  57  186 2   2   2   2   2   2   2   2   2   2   186 91  91  91  91  91  91  91  91  186
2   187 188 188 188 188 188 188 188 189 2   2   2   2   2   2   2   2   2   2   186 91  91  91  91  91  91  91  91  186
2   2   2   2   2   2   2   2   2   2   2   2   2   2   2   2   2   2   2   2   186 91  91  91  91  91  91  91  91  186
2   2   2   2   2   2   2   2   2   2   2   2   2   2   2   2   2   2   2   2   187 188 188 188 188 188 188 188 188 189
2   2   2   2   2   2   2   2   2   2   2   2   2   2   2   2   2   2   2   2   2   2   2   1   2   2   2   2   2   2  
2   2   2   2   2   2   2   2   2   2   2   2   2   2   2   2   2   2   2   2   2   2   2   2   2   2   2   2   2   2 
2   2   2   2   2   2   2   2   2   2   2   2   2   2   2   2   2   2   2   2   2   2   2   2   2   2   2   2   2   2 
2   2   2   2   2   2   2   2   2   2   2   2   2   2   2   2   2   2   2   2   2   2   2   2   2   2   2   2   2   2 
2   2   2   2   2   2   2   2   2   2   2   2   2   2   2   2   2   2   2   2   2   2   2   2   2   2   2   2   2   2 
2   2   2   2   2   2   2   2   2   2   2   2   2   2   2   2   2   2   2   2   2   2   2   2   2   2   2   2   2   2 
2   2   2   2   2   2   2   2   2   2   2   2   2   2   2   2   2   2   2   2   2   2   2   2   2   2   2   2   2   2 
2   2   2   2   2   2   2   2   2   2   2   2   2   2   2   2   2   2   2   2   2   2   2   2   2   2   2   2   2   2 
2   2   2   2   2   2   2   2   2   2   2   2   2   2   2   2   2   2   2   2   2   2   2   2   2   2   2   2   2   2 
2   2   2   2   2   2   2   2   2   2   2   2   2   2   2   2   2   2   2   2   2   2   2   2   2   2   2   2   2   2 
181 188 188 188 188 188 188 188 188 183 2   2   2   2   2   2   2   2   2   2   2   2   2   2   2   2   2   2   2   2  
186 170 170 170 170 170 170 170 170 186 2   2   2   2   2   2   2   2   2   2   2   2   2   2   2   2   2   2   2   2  
186 176 176 176 176 176 176 176 176 186 2   2   2   2   2   2   2   2   2   2   2   2   2   2   2   2   2   2   2   2  
186 91  91  91  91  91  91  91  91  186 2   2   2   2   2   2   2   2   2   2   2   2   2   2   2   2   2   2   2   2
186 91  91  91  91  91  91  91  91  186 2   2   2   2   2   2   2   2   2   2   2   2   2   2   2   2   2   2   2   2
186 91  91  91  91  91  91  91  91  170 2   2   2   2   2   2   2   2   2   2   2   2   2   2   2   2   2   2   2   2
186 91  91  91  91  91  91  91  91  176 2   2   2   2   2   2   2   2   2   2   2   2   2   2   2   2   2   2   2   2
186 91  91  91  91  91  91  91  91  91  1   2   2   2   2   2   2   2   2   2   2   2   2   2   2   2   2   2   2   2
186 91  91  91  91  91  91  91  91  186 2   2   2   2   2   2   2   2   2   2   2   2   2   2   2   2   2   2   2   2
186 91  91  91  91  91  91  91  91  186 2   2   2   2   2   2   2   2   2   2   2   2   2   2   2   2   2   2   2   2
186 91  91  91  91  91  91  91  91  186 2   2   2   2   2   2   2   2   2   2   2   2   2   2   2   2   2   2   2   2
186 91  91  91  91  91  91  91  91  186 2   2   2   2   2   2   2   2   2   2   2   2   2   2   2   2   2   2   2   2
187 188 188 188 188 188 188 188 188 189 2   2   2   2   2   2   2   2   2   2   2   2   2   2   2   2   2   2   2   2
25 10 7
26 10 30
27 19 7
95 1 29
101 2 29
95 1 32
101 2 32
95 1 29
101 2 29
95 27 6
101 28 6
95 27 9
101 28 9
123 1 30
124 1 33
106 6 25
106 7 25
106 8 25
112 7 33
113 8 33
115 7 34
116 8 34
120 5 3 
125 27 7
90 3 1
90 2 24
90 27 1
88 2 2
88 3 2
88 4 2
88 5 2
88 6 2
88 7 2
88 8 2
