45 43
15 28
8
10
0 0
1	1	1	1	1	1	1	1	1	1	1	1	1	1	1	1	1	1	1	1	1	1	1	1	1	1	1	1	1	1	1	1	1	1	1	1	1	1	1	1	1	1	1	1	1
1	1	1	1	1	1	1	1	1	1	1	1	1	1	1	1	1	1	1	1	1	1	1	1	1	1	1	1	1	1	1	1	1	1	1	1	1	1	1	1	1	1	1	1	1
1	1	1	1	1	1	1	1	1	1	1	1	1	1	1	1	1	1	1	1	1	1	1	1	1	1	1	1	1	1	1	1	1	1	1	1	1	1	1	1	1	1	1	1	1
1	1	1	29	29	29	29	29	29	29	29	29	29	29	29	29	29	29	29	29	29	29	29	29	29	29	17	17	17	17	17	17	17	29	29	29	29	29	29	29	29	29	1	1	1
1	1	1	29	29	29	29	29	29	29	29	29	29	29	29	29	29	29	29	29	29	29	29	29	29	29	17	17	17	17	17	17	17	29	29	29	29	29	29	29	29	29	1	1	1
1	1	1	29	29	29	29	29	29	29	29	29	29	29	29	29	29	29	29	29	29	29	29	29	29	29	17	17	17	17	17	17	17	29	29	29	29	29	29	29	29	29	1	1	1
1	1	1	29	29	29	29	29	29	29	29	29	29	29	29	29	29	29	29	29	29	29	29	29	29	29	17	17	17	17	17	17	17	29	29	29	29	29	29	29	29	29	1	1	1
1	1	1	29	29	29	29	29	29	29	29	29	29	29	29	29	29	29	29	29	29	29	29	29	29	29	17	17	17	17	17	17	17	29	29	29	29	29	29	29	29	29	1	1	1
1	1	1	29	29	29	29	29	29	29	29	29	29	29	29	29	29	29	29	29	29	29	29	29	29	29	17	17	17	17	17	17	17	29	29	29	29	29	29	29	29	29	1	1	1
1	1	1	29	29	29	29	29	29	29	29	29	29	29	29	29	29	29	29	29	29	29	29	29	29	29	17	17	17	17	17	17	17	29	29	29	29	29	29	29	29	29	1	1	1
1	1	1	29	29	29	29	29	29	29	29	29	29	29	29	29	29	29	29	29	29	29	29	29	29	29	17	17	17	17	17	17	17	29	29	29	29	29	29	29	29	29	1	1	1
1	1	1	29	29	29	29	29	29	29	29	29	29	29	29	29	29	29	29	29	29	29	29	29	29	29	17	17	17	17	17	17	17	29	29	29	29	29	29	29	29	29	1	1	1
1	1	1	29	29	29	29	29	29	29	29	29	29	29	29	29	29	29	29	29	29	29	29	29	29	29	17	17	17	17	17	17	17	29	29	29	29	29	29	29	29	29	1	1	1
1	1	1	29	29	29	29	29	29	29	29	29	29	29	29	29	29	29	29	29	29	29	29	29	29	29	17	17	17	17	17	17	17	29	29	29	29	29	29	29	29	29	1	1	1
1	1	1	29	29	29	29	29	29	29	29	29	29	29	29	29	29	29	29	29	29	29	29	29	29	29	17	17	17	17	17	17	17	29	29	29	29	29	29	29	29	29	1	1	1
1	1	1	29	29	29	29	29	29	29	29	29	29	29	29	29	29	29	29	29	29	29	29	29	29	29	17	17	17	17	17	17	17	29	29	29	29	29	29	29	29	29	1	1	1
1	1	1	29	29	29	29	29	29	29	29	29	29	29	29	29	29	29	29	29	29	29	29	29	29	29	17	17	17	17	17	17	17	29	29	29	29	29	29	29	29	29	1	1	1
1	1	1	29	29	29	29	29	29	29	29	29	29	29	29	29	29	29	29	29	29	29	29	29	29	29	17	17	1	1	1	17	17	29	29	29	29	29	29	29	29	29	1	1	1
1	1	1	29	29	29	29	16	16	16	16	16	16	16	16	29	29	29	29	29	29	29	29	29	29	29	17	17	0	0	0	17	17	29	29	29	29	29	29	29	29	29	1	1	1
1	1	1	29	29	29	29	16	16	16	16	16	16	16	16	29	29	29	29	29	29	29	29	29	29	29	29	25	19	19	19	25	29	29	29	29	29	29	29	29	29	29	1	1	1
1	1	1	29	29	29	29	16	16	16	16	16	16	16	16	29	29	29	29	29	29	29	29	29	29	29	29	25	19	19	19	25	29	29	29	29	29	29	29	29	29	29	1	1	1
1	1	1	29	29	29	29	16	16	16	16	16	16	16	16	29	29	29	29	29	29	29	29	29	29	29	29	25	25	25	25	25	29	29	29	29	29	29	29	29	29	29	1	1	1
1	1	1	29	29	29	29	16	16	16	16	16	16	16	16	29	29	29	29	29	29	29	29	29	29	29	29	25	25	25	25	25	29	29	29	29	29	29	29	29	29	29	1	1	1
1	1	1	29	29	29	29	17	17	17	17	17	17	17	17	29	29	29	29	29	29	29	29	29	29	29	29	25	25	25	25	25	29	29	29	29	29	29	29	29	29	29	1	1	1
1	1	1	29	29	29	29	17	17	17	17	17	17	17	17	29	29	29	29	29	29	29	29	29	29	29	29	25	25	25	25	25	29	29	29	29	29	29	29	29	29	29	1	1	1
1	1	1	29	29	29	29	17	17	17	17	17	17	17	17	29	29	29	29	29	29	29	29	29	29	29	29	25	25	25	25	25	29	29	29	29	29	29	29	29	29	29	1	1	1
1	1	1	29	29	29	29	17	17	17	17	17	17	17	17	25	25	25	25	25	25	25	25	25	25	25	25	25	25	25	25	25	29	29	29	29	29	29	29	29	29	29	1	1	1
1	1	1	29	29	29	29	17	17	17	17	17	17	17	17	25	25	25	25	25	25	25	25	25	25	25	25	25	25	25	25	25	29	29	29	29	29	29	29	29	29	29	1	1	1
1	1	1	29	29	29	29	17	17	17	17	17	17	17	17	25	25	25	25	25	25	25	25	25	25	25	25	25	25	25	25	25	29	29	29	29	29	29	29	29	29	29	1	1	1
1	1	1	29	29	29	29	17	17	17	17	17	17	17	17	25	25	25	25	25	25	25	25	25	25	25	25	25	25	25	25	25	29	29	29	29	29	29	29	29	29	29	1	1	1
1	1	1	29	29	29	29	17	17	17	17	17	17	17	17	25	25	25	25	25	25	25	25	25	25	25	25	25	25	25	25	25	29	29	29	29	29	29	29	29	29	29	1	1	1
1	1	1	29	29	29	29	17	17	17	17	17	17	17	17	29	29	29	29	29	29	29	29	29	29	29	29	29	29	29	29	29	29	29	29	29	29	29	29	29	29	29	1	1	1
1	1	1	29	29	29	29	17	17	17	17	17	17	17	17	29	29	29	29	29	29	29	29	29	29	29	29	29	29	29	29	29	29	29	29	29	29	29	29	29	29	29	1	1	1
1	1	1	29	29	29	29	17	17	17	17	17	17	17	17	29	29	29	29	29	29	29	29	29	29	29	29	29	29	29	29	29	29	29	29	29	29	29	29	29	29	29	1	1	1
1	1	1	29	29	29	29	17	17	17	17	17	17	17	17	29	29	29	29	29	29	29	29	29	29	29	29	29	29	29	29	29	29	29	29	29	29	29	29	29	29	29	1	1	1
1	1	1	29	29	29	29	17	17	17	17	17	17	17	17	29	29	29	29	29	29	29	29	29	29	29	29	29	29	29	29	29	29	29	29	29	29	29	29	29	29	29	1	1	1
1	1	1	29	29	29	29	17	17	17	17	17	17	17	17	29	29	29	29	29	29	29	29	29	29	29	29	29	29	29	29	29	29	29	29	29	29	29	29	29	29	29	1	1	1
1	1	1	29	29	29	29	17	17	17	17	17	17	17	17	29	29	29	29	29	29	29	29	29	29	29	29	29	29	29	29	29	29	29	29	29	29	29	29	29	29	29	1	1	1
1	1	1	29	29	29	29	17	17	17	17	17	17	17	17	29	29	29	29	29	29	29	29	29	29	29	29	29	29	29	29	29	29	29	29	29	29	29	29	29	29	29	1	1	1
1	1	1	29	29	29	29	17	17	17	17	17	17	17	17	29	29	29	29	29	29	29	29	29	29	29	29	29	29	29	29	29	29	29	29	29	29	29	29	29	29	29	1	1	1
1	1	1	1	1	1	1	1	1	1	1	1	1	1	1	1	1	1	1	1	1	1	1	1	1	1	1	1	1	1	1	1	1	1	1	1	1	1	1	1	1	1	1	1	1
1	1	1	1	1	1	1	1	1	1	1	1	1	1	1	1	1	1	1	1	1	1	1	1	1	1	1	1	1	1	1	1	1	1	1	1	1	1	1	1	1	1	1	1	1
1	1	1	1	1	1	1	1	1	1	1	1	1	1	1	1	1	1	1	1	1	1	1	1	1	1	1	1	1	1	1	1	1	1	1	1	1	1	1	1	1	1	1	1	1
28 14 26
28 14 27
28 14 28
28 14 29
28 14 30
29 28 18
29 29 18
29 30 18
61 832 512
62 832 544
62 832 640
62 832 736
65 480 800
65 576 800
65 672 800
65 768 800
67 832 824
71 0 0