30 11
6 9
16
5 3
181 188 188 188 188 188 188 188 188 183 2   2   2   2   2   2   2   2   2   2  181 188 188 188 188 188 188 188 188 183
186 170 170 170 170 170 170 170 170 186 2   2   2   2   2   2   2   2   2   2  186 170 170 170 170 170 170 170 170 186
186 176 183 176 183 176 176 176 176 186 2   2   2   2   2   2   2   2   2   2  186 176 176 176 176 183 176 183 176 186
186 14  185 14  185 14  14  14  14  186 2   2   2   2   2   2   2   2   2   2  186 14  14  14  14  185 14  185 14  186
186 14  188 14  188 14  14  14  14  186 2   2   2   2   2   2   2   2   2   2  186 14  14  14  14  188 14  188 14  186
186 14  170 14  170 14  14  14  14  186 2   2   2   2   2   2   2   2   2   2  186 14  14  14  14  170 14  170 14  186
186 14  14  14  14  14  14  14  14  186 2   2   2   2   2   2   2   2   2   2  186 14  14  14  14  14  14  14  14  186
186 14  14  14  14  14  14  14  14  186 2   2   2   2   2   2   2   2   2   2  186 14  14  14  14  14  14  14  14  186
186 14  14  14  14  14  14  14  14  186 2   2   2   2   2   2   2   2   2   2  186 14  14  14  14  14  14  14  14  186
187 188 188 188 188 188 14  188 188 189 2   2   2   2   2   2   2   2   2   2  187 188 188 14  188 188 188 188 188 189
2   2   2   2   2   2   1   2   2   2   2   2   2   2   2   2   2   2   2   2  2   2   2   1   2   2   2   2   2   2  
30 6 10
31 23 10
141 1 2
141 3 2
141 28 2
141 26 2
143 6 1
143 7 1
143 23 1
143 22 1
146 7 6
147 3 3
148 6 3
149 21 8
150 22 3
151 28 3
10 10
9 10
8 20

