23 35
5 12
25
0 0
99  99  99  99  99  99  99  99  99  99  99  99  99  99  99  99  99  99  99  99  99  99  99
99  99  99  99  99  99  99  99  99  99  99  99  99  99  99  99  99  99  99  99  99  99  99
99  99  99  99  99  99  99  99  99  99  99  99  99  99  99  99  99  99  99  99  99  99  99
99  99  99  99  99  99  99  99  99  102 102 102 102 99  99  99  99  99  99  99  99  99  99
99  99  99  99  99  99  99  99  100 181 188 188 188 183 98  99  99  99  99  99  99  99  99
99  99  99  99  173 173 173 173 173 173 170 170 170 173 173 173 173 173 173 99  99  99  99  
99  99  99  99  173 173 173 173 173 173 176 176 176 173 173 173 173 173 173 99  99  99  99 
99  99  99  99  173 173 173 173 173 173 2   2   2   173 173 173 173 173 173 99  99  99  99 
99  99  99  99  173 173 173 173 173 173 2   2   2   173 173 173 173 173 173 99  99  99  99 
99  99  99  99  173 173 173 173 173 186 2   2   2   186 173 173 173 173 173 99  99  99  99 
99  99  99  99  173 173 173 173 173 186 2   2   2   186 173 173 173 173 173 99  99  99  99 
99  99  99  99  176 176 176 176 176 186 1   1   1   186 176 176 176 176 176 99  99  99  99 
99  99  99  99  99  99  99  99  100 186 49  50  51  186 98  99  99  99  99  99  99  99  99 
99  99  99  99  99  99  99  99  100 186 52  53  54  186 98  99  99  99  99  99  99  99  99 
99  99  99  99  99  99  99  99  100 186 52  53  54  186 98  99  99  99  99  99  99  99  99 
99  99  99  99  99  99  99  99  100 186 52  53  54  186 98  99  99  99  99  99  99  99  99 
99  99  99  99  99  99  99  99  100 186 52  53  54  186 98  99  99  99  99  99  99  99  99 
99  99  99  99  99  99  99  99  100 186 52  53  54  186 98  99  99  99  99  99  99  99  99
99  99  99  99  99  99  99  99  100 186 52  53  54  186 98  99  99  99  99  99  99  99  99 
99  99  99  99  99  99  99  99  100 186 52  53  54  186 98  99  99  99  99  99  99  99  99 
99  99  99  99  99  99  99  99  100 186 52  53  54  186 98  99  99  99  99  99  99  99  99 
99  99  99  99  99  99  99  99  100 186 52  53  54  186 98  99  99  99  99  99  99  99  99 
99  99  99  99  99  99  99  99  100 186 52  53  54  186 98  99  99  99  99  99  99  99  99 
99  99  99  99  99  99  99  99  100 186 52  53  54  186 98  99  99  99  99  99  99  99  99 
99  99  99  99  99  99  99  99  100 186 55  56  57  186 98  99  99  99  99  99  99  99  99 
99  99  99  99  99  99  99  99  100 186 1   1   1   186 98  99  99  99  99  99  99  99  99 
99  99  99  99  99  99  99  99  100 186 2   2   2   186 98  99  99  99  99  99  99  99  99 
99  99  99  99  99  99  99  99  100 186 2   2   2   186 98  99  99  99  99  99  99  99  99 
99  99  99  99  99  99  99  99  100 186 2   2   2   186 98  99  99  99  99  99  99  99  99 
99  99  99  99  99  99  99  99  100 186 2   2   2   186 98  99  99  99  99  99  99  99  99 
99  99  99  99  99  99  99  99  100 181 188 188 188 183 98  99  99  99  99  99  99  99  99 
99  99  99  99  99  99  99  99  100 170 170 170 170 170 98  99  99  99  99  99  99  99  99
99  99  99  99  99  99  99  99  100 176 176 176 176 176 98  99  99  99  99  99  99  99  99
99  99  99  99  99  99  99  99  99  96  96  96  96  96  99  99  99  99  99  99  99  99  99
99  99  99  99  99  99  99  99  99  99  99  99  99  99  99  99  99  99  99  99  99  99  99 
18 10 25
18 11 25
18 12 25
18 10 26
18 11 26
18 12 26
19 10 11
19 11 11
19 12 11
19 10 10
19 11 10
19 12 10
86 15 10
87 5 7
88 4 11
88 5 11
88 6 11
88 7 11
88 8 11
88 14 11
88 15 11
88 16 11
88 17 11
88 18 11
89 15 7


