45 41
16 26
8
0
0 0
1	1	1	1	1	1	1	1	1	1	1	1	1	1	1	1	1	1	1	1	1	1	1	1	1	1	1	1	1	1	1	1	1	1	1	1	1	1	1	1	1	1	1	1	1
1	1	1	1	1	1	1	1	1	1	1	1	1	1	1	1	1	1	1	1	1	1	1	1	1	1	1	1	1	1	1	1	1	1	1	1	1	1	1	1	1	1	1	1	1
1	1	1	1	1	1	1	1	1	1	1	1	1	1	1	1	1	1	1	1	1	1	1	1	1	1	1	1	1	1	1	1	1	1	1	1	1	1	1	1	1	1	1	1	1
1	1	1	6	6	6	6	6	6	6	6	6	6	6	6	6	6	6	6	6	6	6	6	6	6	6	17	17	17	17	17	17	17	6	6	6	6	6	6	6	6	6	1	1	1
1	1	1	6	6	6	6	6	6	6	6	6	6	6	6	6	6	6	6	6	6	6	6	6	6	6	17	17	17	17	17	17	17	6	6	6	6	6	6	6	6	6	1	1	1
1	1	1	6	6	6	6	6	6	6	6	6	6	6	6	6	6	6	6	6	6	6	6	6	6	6	17	17	17	17	17	17	17	6	6	6	6	6	6	6	6	6	1	1	1
1	1	1	6	6	6	6	6	6	6	6	6	6	6	6	6	6	6	6	6	6	6	6	6	6	6	17	17	17	17	17	17	17	6	6	6	6	6	6	6	6	6	1	1	1
1	1	1	6	6	6	6	6	6	6	6	6	6	6	6	6	6	6	6	6	6	6	6	6	6	6	17	17	17	17	17	17	17	6	6	6	6	6	6	6	6	6	1	1	1
1	1	1	6	6	6	6	6	6	6	6	6	6	6	6	6	6	6	6	6	6	6	6	6	6	6	17	17	17	17	17	17	17	6	6	6	6	6	6	6	6	6	1	1	1
1	1	1	6	6	6	6	6	6	6	6	6	6	6	6	6	6	6	6	6	6	6	6	6	6	6	17	17	17	17	17	17	17	6	6	6	6	6	6	6	6	6	1	1	1
1	1	1	6	6	6	6	6	6	6	6	6	6	6	6	6	6	6	6	6	6	6	6	6	6	6	17	17	17	17	17	17	17	6	6	6	6	6	6	6	6	6	1	1	1
1	1	1	6	6	6	6	6	6	6	6	6	6	6	6	6	6	6	6	6	6	6	6	6	6	6	17	17	17	17	17	17	17	6	6	6	6	6	6	6	6	6	1	1	1
1	1	1	6	6	6	6	6	6	6	6	6	6	6	6	6	6	6	6	6	6	6	6	6	6	6	17	17	17	17	17	17	17	6	6	6	6	6	6	6	6	6	1	1	1
1	1	1	6	6	6	6	6	6	6	6	6	6	6	6	6	6	6	6	6	6	6	6	6	6	6	17	17	1	1	1	17	17	6	6	6	6	6	6	6	6	6	1	1	1
1	1	1	6	6	6	6	6	6	6	6	6	6	6	6	6	6	6	6	6	6	6	6	6	6	6	17	17	1	1	1	17	17	6	6	6	6	6	6	6	6	6	1	1	1
1	1	1	6	6	6	6	6	6	6	6	6	6	6	6	6	6	6	6	6	6	6	6	6	6	6	17	17	0	0	0	17	17	6	6	6	6	6	6	6	6	6	1	1	1
1	1	1	6	6	6	6	6	6	6	6	6	6	6	6	6	6	6	6	6	6	6	6	6	6	6	17	17	19	19	19	17	17	6	6	6	6	6	6	6	6	6	1	1	1
1	1	1	6	6	6	6	6	6	6	6	6	6	6	6	6	6	6	6	6	6	6	6	6	6	6	17	17	19	19	19	17	17	6	6	6	6	6	6	6	6	6	1	1	1
1	1	1	6	6	6	6	6	6	6	6	6	6	6	6	6	6	6	6	6	6	6	6	6	6	6	17	17	19	19	19	17	17	6	6	6	6	6	6	6	6	6	1	1	1
1	1	1	6	6	6	6	6	6	6	6	6	6	6	6	6	6	6	6	6	6	6	6	6	6	6	6	24	24	24	24	24	6	6	6	6	6	6	6	6	6	6	1	1	1
1	1	1	6	6	6	6	6	6	6	6	6	6	6	6	6	6	6	6	6	6	6	6	6	6	6	6	24	24	24	24	24	6	6	6	6	6	6	6	6	6	6	1	1	1
1	1	1	6	6	6	6	6	6	6	6	6	6	6	6	6	6	6	6	6	6	6	6	6	6	6	6	24	24	24	24	24	6	6	6	6	6	6	6	6	6	6	1	1	1
1	1	1	6	6	6	6	6	6	6	6	6	6	6	6	6	6	6	6	6	6	6	6	6	6	6	6	24	24	24	24	24	6	6	6	6	6	6	6	6	6	6	1	1	1
1	1	1	6	6	6	6	6	6	6	6	6	6	6	6	6	6	6	6	6	6	6	6	6	6	6	6	24	24	24	24	24	6	6	6	6	6	6	6	6	6	6	1	1	1
1	1	1	6	6	6	6	6	6	6	6	6	6	6	6	0	24	24	24	24	24	24	24	24	24	24	24	24	24	24	24	24	6	6	6	6	6	6	6	6	6	6	1	1	1
1	1	1	6	6	6	6	6	6	6	6	6	6	6	6	0	24	24	24	24	24	24	24	24	24	24	24	24	24	24	24	24	6	6	6	6	6	6	6	6	6	6	1	1	1
1	1	1	6	6	6	6	6	6	6	6	6	6	6	6	0	24	24	24	24	24	24	24	24	24	24	24	24	24	24	24	24	6	6	6	6	6	6	6	6	6	6	1	1	1
1	1	1	6	6	6	6	6	6	6	6	6	6	6	6	0	24	24	24	24	24	24	24	24	24	24	24	24	24	24	24	24	6	6	6	6	6	6	6	6	6	6	1	1	1
1	1	1	6	6	6	6	6	6	6	6	6	6	6	6	0	24	24	24	24	24	24	24	24	24	24	24	24	24	24	24	24	6	6	6	6	6	6	6	6	6	6	1	1	1
1	1	1	6	6	6	6	6	6	6	6	6	6	6	6	6	6	6	6	6	6	6	6	6	6	6	6	6	6	6	6	6	6	6	6	6	6	6	6	6	6	6	1	1	1
1	1	1	6	6	6	6	6	6	6	6	6	6	6	6	6	6	6	6	6	6	6	6	6	6	6	6	6	6	6	6	6	6	6	6	6	6	6	6	6	6	6	1	1	1
1	1	1	6	6	6	6	6	6	6	6	6	6	6	6	6	6	6	6	6	6	6	6	6	6	6	6	6	6	6	6	6	6	6	6	6	6	6	6	6	6	6	1	1	1
1	1	1	6	6	6	6	6	6	6	6	6	6	6	6	6	6	6	6	6	6	6	6	6	6	6	6	6	6	6	6	6	6	6	6	6	6	6	6	6	6	6	1	1	1
1	1	1	6	6	6	6	6	6	6	6	6	6	6	6	6	6	6	6	6	6	6	6	6	6	6	6	6	6	6	6	6	6	6	6	6	6	6	6	6	6	6	1	1	1
1	1	1	6	6	6	6	6	6	6	6	6	6	6	6	6	6	6	6	6	6	6	6	6	6	6	6	6	6	6	6	6	6	6	6	6	6	6	6	6	6	6	1	1	1
1	1	1	6	6	6	6	6	6	6	6	6	6	6	6	6	6	6	6	6	6	6	6	6	6	6	6	6	6	6	6	6	6	6	6	6	6	6	6	6	6	6	1	1	1
1	1	1	6	6	6	6	6	6	6	6	6	6	6	6	6	6	6	6	6	6	6	6	6	6	6	6	6	6	6	6	6	6	6	6	6	6	6	6	6	6	6	1	1	1
1	1	1	6	6	6	6	6	6	6	6	6	6	6	6	6	6	6	6	6	6	6	6	6	6	6	6	6	6	6	6	6	6	6	6	6	6	6	6	6	6	6	1	1	1
1	1	1	1	1	1	1	1	1	1	1	1	1	1	1	1	1	1	1	1	1	1	1	1	1	1	1	1	1	1	1	1	1	1	1	1	1	1	1	1	1	1	1	1	1
1	1	1	1	1	1	1	1	1	1	1	1	1	1	1	1	1	1	1	1	1	1	1	1	1	1	1	1	1	1	1	1	1	1	1	1	1	1	1	1	1	1	1	1	1
1	1	1	1	1	1	1	1	1	1	1	1	1	1	1	1	1	1	1	1	1	1	1	1	1	1	1	1	1	1	1	1	1	1	1	1	1	1	1	1	1	1	1	1	1
28 15 24
28 15 25
28 15 26
28 15 27
28 15 28
29 28 15
29 29 15
29 30 25

