17 19
12 13
6
2
0 0
1	1	1	1	1	1	1	1	1	1	1	1	1	1	1	1	1
1	1	1	1	1	1	1	1	1	1	1	1	1	1	1	1	1
1	1	1	1	1	1	1	1	1	1	1	1	1	1	1	1	1
1	1	1	16	16	16	16	16	16	16	16	16	16	1	1	1	1
1	1	1	16	17	17	17	17	17	17	17	17	16	1	1	1	1
1	1	1	16	17	17	17	17	17	17	17	17	16	1	1	1	1
1	1	1	16	17	17	17	17	17	17	17	17	16	1	1	1	1
1	1	1	16	14	14	14	14	14	14	14	14	16	1	1	1	1
1	1	1	16	14	14	14	14	14	14	14	14	16	1	1	1	1
1	1	1	16	14	14	14	14	14	14	14	14	16	1	1	1	1
1	1	1	16	14	14	14	14	14	14	14	14	17	1	1	1	1
1	1	1	16	14	14	14	14	14	14	14	14	17	1	1	1	1
1	1	1	16	14	14	14	14	14	14	14	14	17	1	1	1	1
1	1	1	16	14	14	14	14	14	14	14	14	14	0	1	1	1
1	1	1	16	14	14	14	14	14	14	14	14	16	1	1	1	1
1	1	1	16	16	16	16	16	16	16	16	16	16	1	1	1	1
1	1	1	1	1	1	1	1	1	1	1	1	1	1	1	1	1
1	1	1	1	1	1	1	1	1	1	1	1	1	1	1	1	1
1	1	1	1	1	1	1	1	1	1	1	1	1	1	1	1	1
26 13 13
101 4 12
101 5 12
101 4 8 
101 5 8
133 8 7
54 128 224
54 128 352