30 78
23 24
0
0
0 0
1	1	1	1	1	1	1	1	1	1	1	1	1	1	1	1	1	1	1	1	1	1	1	1	1	1	1	1	1	1	
1	1	1	1	1	1	1	1	1	1	1	1	1	1	1	1	1	1	1	1	1	1	1	1	1	1	1	1	1	1	
1	1	1	1	1	1	1	1	1	1	1	1	1	1	1	1	1	1	1	1	1	1	1	1	1	1	1	1	1	1	
1	1	1	30	30	30	30	30	30	30	30	30	30	30	30	30	30	30	30	30	30	30	30	30	30	30	30	1	1	1
1	1	1	30	31	31	31	31	31	31	31	31	31	31	31	31	31	31	31	31	31	31	31	31	31	31	30	1	1	1
1	1	1	30	31	31	31	31	31	31	31	31	31	31	31	31	31	31	31	31	31	31	31	31	31	31	30	1	1	1
1	1	1	30	31	31	31	31	31	31	31	31	31	31	31	31	31	31	31	31	31	31	31	31	31	31	30	1	1	1
1	1	1	30	31	31	31	31	31	31	31	31	31	31	31	31	31	31	31	31	20	40	40	40	40	40	30	1	1	1
1	1	1	30	31	31	31	31	31	31	31	31	31	31	31	31	31	31	31	20	20	40	40	40	40	40	30	1	1	1
1	1	1	30	31	31	31	31	31	31	31	31	31	31	31	31	31	31	20	20	20	40	40	40	40	40	30	1	1	1
1	1	1	30	31	31	31	31	31	31	31	31	31	31	31	31	31	20	20	20	30	40	40	40	40	40	30	1	1	1
1	1	1	30	31	31	31	31	31	31	31	31	31	31	31	31	20	20	20	30	30	40	40	40	40	40	30	1	1	1
1	1	1	30	31	31	31	31	31	31	31	31	31	31	31	20	20	20	30	30	30	40	40	40	40	40	30	1	1	1
1	1	1	30	31	31	31	31	31	31	31	31	31	31	20	20	20	30	30	31	30	40	40	40	40	40	30	1	1	1
1	1	1	30	31	31	31	31	31	31	31	31	31	20	20	20	30	30	31	31	30	40	40	40	40	40	30	1	1	1
1	1	1	30	31	31	31	31	31	31	31	31	20	20	20	30	30	31	31	31	30	40	40	40	40	40	30	1	1	1
1	1	1	30	31	31	31	31	31	31	31	20	20	20	30	30	31	31	31	31	30	40	40	40	40	40	30	1	1	1
1	1	1	30	31	31	31	31	31	31	20	20	20	30	30	31	31	31	31	31	30	40	40	40	40	40	30	1	1	1
1	1	1	30	31	31	31	31	31	20	20	20	30	30	31	31	31	31	31	31	30	40	40	40	40	40	30	1	1	1
1	1	1	30	31	31	31	31	20	20	20	30	30	31	31	31	31	31	31	31	30	40	40	40	40	40	30	1	1	1
1	1	1	30	31	31	31	20	20	20	30	30	31	31	31	31	31	31	31	31	30	40	40	40	40	40	30	1	1	1
1	1	1	30	40	40	40	20	20	30	30	31	31	31	31	31	31	31	31	31	30	40	40	40	40	40	30	1	1	1
1	1	1	30	40	40	40	20	30	30	31	31	31	31	31	31	31	31	31	31	30	40	40	40	40	40	30	1	1	1
1	1	1	30	40	40	40	30	30	31	31	31	31	31	31	31	31	31	31	31	30	40	40	40	40	40	30	1	1	1
1	1	1	30	18	18	18	30	31	31	31	31	31	31	31	31	31	31	31	31	30	30	30	40	30	30	30	1	1	1
1	1	1	30	18	18	18	30	31	31	31	31	31	31	31	31	31	31	31	31	30	1	1	0	1	1	1	1	1	1
1	1	1	30	18	18	18	30	31	31	31	31	31	31	31	31	31	31	31	31	30	1	1	1	1	1	1	1	1	1
1	1	1	30	18	18	18	30	40	40	40	40	40	40	40	40	40	40	40	40	30	1	1	1	1	1	1	1	1	1
1	1	1	30	18	18	18	30	40	40	40	40	40	40	40	40	40	40	40	40	30	1	1	1	1	1	1	1	1	1
1	1	1	30	18	18	18	30	40	40	40	40	40	40	40	40	40	40	40	40	30	1	1	1	1	1	1	1	1	1
1	1	1	30	18	18	18	30	40	40	40	40	40	40	40	40	40	40	40	40	30	1	1	1	1	1	1	1	1	1
1	1	1	30	18	18	18	30	40	40	40	40	40	40	40	40	40	40	40	40	30	1	1	1	1	1	1	1	1	1
1	1	1	30	18	18	18	30	40	40	40	40	40	40	40	40	40	40	40	40	30	1	1	1	1	1	1	1	1	1
1	1	1	30	18	18	18	30	40	40	40	40	40	40	40	40	40	40	40	40	30	1	1	1	1	1	1	1	1	1
1	1	1	30	18	18	18	31	40	40	40	40	40	40	40	40	40	40	40	40	30	1	1	1	1	1	1	1	1	1
1	1	1	30	18	18	18	31	40	40	40	40	40	40	40	40	40	40	40	40	30	1	1	1	1	1	1	1	1	1
1	1	1	30	18	18	18	31	40	40	40	40	40	40	40	40	40	40	40	40	30	1	1	1	1	1	1	1	1	1
1	1	1	30	40	40	40	40	40	40	40	40	40	40	40	40	40	40	40	40	30	1	1	1	1	1	1	1	1	1
1	1	1	30	40	40	40	40	40	40	40	40	40	40	40	40	40	40	40	40	30	1	1	1	1	1	1	1	1	1
1	1	1	30	40	40	40	40	40	40	40	40	40	40	40	40	40	40	40	40	30	1	1	1	1	1	1	1	1	1
1	1	1	30	40	40	40	40	40	40	40	40	40	40	40	40	40	40	40	40	30	1	1	1	1	1	1	1	1	1
1	1	1	30	40	40	40	40	40	40	40	40	40	40	40	40	40	40	40	40	30	1	1	1	1	1	1	1	1	1
1	1	1	30	40	40	40	40	40	40	40	40	40	40	40	40	40	40	40	40	30	1	1	1	1	1	1	1	1	1
1	1	1	30	40	40	40	40	40	40	40	40	40	40	40	40	40	40	40	40	30	1	1	1	1	1	1	1	1	1
1	1	1	30	30	30	30	30	30	30	40	40	40	40	30	30	30	30	30	30	30	30	30	30	1	1	1	1	1	1
1	1	1	1	1	30	31	31	31	30	18	18	18	18	30	31	31	31	31	31	31	31	31	30	1	1	1	1	1	1
1	1	1	1	1	30	31	31	31	30	18	18	18	18	30	31	31	31	31	31	31	31	31	30	1	1	1	1	1	1
1	1	1	1	1	30	31	31	31	31	18	18	18	18	31	31	31	31	31	31	31	31	31	30	1	1	1	1	1	1
1	1	1	1	1	30	40	40	40	31	18	18	18	18	31	40	40	40	40	40	40	40	40	30	1	1	1	1	1	1
1	1	1	1	1	30	40	40	40	31	18	18	18	18	31	40	40	40	40	40	40	40	40	30	1	1	1	1	1	1
1	1	1	1	1	30	40	40	40	40	40	40	40	40	40	40	40	40	40	40	40	40	40	30	1	1	1	1	1	1
1	1	1	1	1	30	40	40	40	40	40	40	40	40	40	40	40	40	40	40	40	40	40	30	1	1	1	1	1	1
1	1	1	1	1	30	40	40	40	40	40	40	40	40	40	40	40	40	40	40	40	40	40	30	1	1	1	1	1	1
1	1	1	1	1	30	40	40	40	40	40	40	40	40	40	40	40	40	40	40	40	40	40	30	1	1	1	1	1	1
1	1	1	1	1	30	40	40	40	40	40	40	40	40	40	40	40	40	40	40	40	40	40	30	1	1	1	1	1	1
1	1	1	1	1	30	40	40	40	40	40	40	40	40	40	40	40	40	40	40	40	40	40	30	1	1	1	1	1	1
1	1	1	1	1	30	40	40	40	40	40	40	40	40	40	40	40	40	40	40	40	40	40	30	1	1	1	1	1	1
1	1	1	1	1	30	30	30	30	30	40	40	40	30	30	30	30	30	30	30	30	30	30	30	1	1	1	1	1	1
1	1	1	1	1	1	1	1	1	30	18	18	18	30	1	1	1	1	1	1	1	1	1	1	1	1	1	1	1	1
1	1	1	1	1	1	1	1	1	30	18	18	18	30	1	1	1	1	1	1	1	1	1	1	1	1	1	1	1	1
1	1	1	1	30	30	30	30	30	30	18	18	18	30	30	30	30	30	30	30	1	1	1	1	1	1	1	1	1	1
1	1	1	1	31	31	31	31	31	31	18	18	18	31	31	31	31	31	31	31	1	1	1	1	1	1	1	1	1	1
1	1	30	30	30	31	31	31	31	31	18	18	18	31	31	31	31	31	31	31	1	1	1	1	1	1	1	1	1	1
1	1	30	31	31	31	31	31	31	31	18	18	18	31	31	31	31	31	31	31	1	1	1	1	1	1	1	1	1	1
1	1	31	31	31	31	31	31	20	40	40	40	40	40	21	31	31	31	31	30	30	30	30	30	30	30	1	1	1	1
1	1	31	31	31	31	31	20	20	40	40	40	40	40	21	21	31	31	31	31	31	31	31	31	31	30	1	1	1	1
1	1	31	40	40	40	20	20	20	40	40	40	40	40	21	21	21	31	31	31	31	31	31	31	31	30	1	1	1	1
1	1	0	40	40	40	20	20	1	30	30	30	30	30	1	21	21	21	31	31	31	31	31	31	31	30	1	1	1	1
1	1	30	40	40	40	20	1	1	1	1	1	1	1	1	1	21	21	21	40	40	40	40	40	40	30	1	1	1	1
1	1	30	30	30	30	1	1	1	1	1	1	1	1	1	1	1	21	21	40	40	40	40	40	40	30	1	1	1	1
1	1	1	1	1	1	1	1	1	1	1	1	1	1	1	1	1	1	21	40	40	40	40	40	40	30	1	1	1	1
1	1	1	1	1	1	1	1	1	1	1	1	1	1	1	1	1	1	30	40	40	40	40	40	40	30	1	1	1	1
1	1	1	1	1	1	1	1	1	1	1	1	1	1	1	1	1	1	30	40	40	40	40	40	40	30	1	1	1	1
1	1	1	1	1	1	1	1	1	1	1	1	1	1	1	1	1	1	30	40	40	40	40	40	40	30	1	1	1	1
1	1	1	1	1	1	1	1	1	1	1	1	1	1	1	1	1	1	30	30	30	30	30	30	30	30	1	1	1	1
1	1	1	1	1	1	1	1	1	1	1	1	1	1	1	1	1	1	1	1	1	1	1	1	1	1	1	1	1	1	
1	1	1	1	1	1	1	1	1	1	1	1	1	1	1	1	1	1	1	1	1	1	1	1	1	1	1	1	1	1	
1	1	1	1	1	1	1	1	1	1	1	1	1	1	1	1	1	1	1	1	1	1	1	1	1	1	1	1	1	1	
26