88 77
24 24
2
37
0 0
1	1	1	1	1	1	1	1	1	1	1	1	1	1	1	1	1	1	1	1	1	1	1	1	1	1	1	1	1	1	1	1	1	1	1	1	1	1	1	1	1	1	1	1	1	1	1	1	1	1	1	1	1	1	1	1	1	1	1	1	1	1	1	1	1	1	1	1	1	1	1	1	1	1	1	1	1	1	1	1	1	1	1	1	1	1	1	1
1	1	1	1	1	1	1	1	1	1	1	1	1	1	1	1	1	1	1	1	1	1	1	1	1	1	1	1	1	1	1	1	1	1	1	1	1	1	1	1	1	1	1	1	1	1	1	1	1	1	1	1	1	1	1	1	1	1	1	1	1	1	1	1	1	1	1	1	1	1	1	1	1	1	1	1	1	1	1	1	1	1	1	1	1	1	1	1
1	1	1	1	1	1	1	1	1	1	1	1	1	1	1	1	1	1	1	1	1	1	1	1	1	1	1	1	1	1	1	1	1	1	1	1	1	1	1	1	1	1	1	1	1	1	1	1	1	1	1	1	1	1	1	1	1	1	1	1	1	1	1	1	1	1	1	1	1	1	1	1	1	1	1	1	1	1	1	1	1	1	1	1	1	1	1	1
1	1	1	37	37	37	37	37	37	37	37	37	37	37	37	37	37	37	37	37	37	37	37	37	37	37	37	37	37	37	37	37	37	37	37	37	37	37	37	37	37	37	37	37	37	37	37	37	37	37	37	37	37	37	37	37	37	37	37	37	37	37	37	37	37	30	30	30	30	30	30	30	30	30	30	37	37	37	37	37	37	37	37	37	30	1	1	1
1	1	1	37	37	37	37	37	37	37	37	37	37	37	37	37	37	37	37	37	37	37	37	37	37	37	37	37	37	37	37	37	37	37	37	37	37	37	37	37	37	37	37	37	37	37	37	37	37	37	37	37	37	37	37	37	37	37	37	37	37	37	37	37	37	30	30	30	30	30	30	30	30	30	30	37	37	37	37	37	37	37	37	37	30	1	1	1
1	1	1	37	37	37	37	37	37	37	37	37	37	37	37	37	37	37	37	37	37	37	37	37	37	37	37	37	37	37	37	37	37	37	37	37	37	37	37	37	37	37	37	37	37	37	37	37	37	37	37	37	37	37	37	37	37	37	37	37	37	37	37	37	37	30	30	30	30	30	30	30	30	30	30	37	37	37	37	37	37	37	37	37	30	1	1	1
1	1	1	37	37	37	37	37	37	37	37	37	37	37	37	37	37	37	37	37	37	37	37	37	37	37	37	37	37	37	37	37	37	37	37	37	37	37	37	37	37	37	37	37	37	37	37	37	37	37	37	37	37	37	37	37	37	37	37	37	37	37	37	37	37	30	30	30	30	30	30	30	30	30	30	37	37	37	37	37	37	37	37	37	30	1	1	1
1	1	1	37	37	37	37	37	37	37	37	37	37	37	37	37	37	37	37	37	37	37	37	37	37	37	37	37	37	37	37	37	37	37	37	37	37	37	37	37	37	37	37	37	37	37	37	37	37	37	37	37	37	37	37	37	37	37	37	37	37	37	37	37	37	30	30	30	30	30	30	30	30	30	30	37	37	37	37	37	37	37	37	37	30	1	1	1
1	1	1	37	37	37	37	37	37	37	37	37	37	37	37	37	37	37	37	37	37	37	37	37	37	37	37	37	37	37	37	37	37	37	37	37	37	37	37	37	37	37	37	37	37	37	37	37	37	37	37	37	37	37	37	37	37	37	37	37	37	37	37	37	37	30	30	30	30	30	30	30	30	30	30	37	37	37	37	37	37	37	37	37	30	1	1	1
1	1	1	37	37	37	37	37	37	37	37	37	37	37	37	37	37	37	37	37	37	37	37	37	37	37	37	37	37	37	37	37	37	37	37	37	37	37	37	37	37	37	37	37	37	37	37	37	37	37	37	37	37	37	37	37	37	37	37	37	37	37	37	37	37	30	30	30	30	30	30	30	30	30	30	37	37	37	37	37	37	37	37	37	30	1	1	1
1	1	1	37	37	37	37	37	37	37	37	37	37	37	37	37	37	37	37	37	37	37	37	37	37	37	37	37	37	37	37	37	37	37	37	37	37	37	37	37	37	37	37	37	37	37	37	37	37	37	37	37	37	37	37	37	37	37	37	37	37	37	37	37	37	30	30	30	30	30	30	30	30	30	30	37	37	37	37	37	37	37	37	37	30	1	1	1
1	1	1	37	37	37	37	37	37	37	37	37	37	37	37	37	37	37	37	37	37	37	37	37	37	37	37	37	37	37	37	37	37	37	37	37	37	37	37	37	30	30	30	30	30	30	30	30	30	37	37	37	37	37	37	37	37	37	37	37	37	37	37	37	37	30	30	30	30	30	30	30	30	30	30	30	30	30	30	30	30	37	30	30	30	1	1	1
1	1	1	37	37	37	37	37	37	37	37	37	37	37	37	37	37	37	37	37	37	37	37	37	37	37	37	37	37	37	37	37	37	37	37	37	37	37	37	37	30	30	30	30	30	30	30	30	30	37	37	37	37	37	37	37	37	37	37	37	37	37	37	37	37	31	31	31	31	31	31	31	31	31	31	31	31	31	31	31	30	30	30	31	30	1	1	1
1	1	1	37	37	37	37	37	37	37	37	37	37	37	37	37	37	37	37	37	37	37	37	37	37	37	37	37	37	37	37	37	37	37	37	37	37	37	37	37	30	30	30	30	30	30	30	30	30	37	37	37	37	37	37	37	37	37	37	37	37	37	37	37	37	31	31	31	31	31	31	31	31	31	31	31	31	31	31	31	31	31	31	31	30	1	1	1
1	1	1	37	37	37	37	37	37	37	37	37	37	37	37	25	25	25	25	25	25	25	25	25	25	25	25	25	25	25	25	25	25	25	37	37	37	37	37	37	30	30	30	30	30	30	30	30	30	37	37	37	37	37	37	37	37	37	37	37	37	37	37	37	37	31	31	31	31	31	31	31	31	31	31	31	31	31	31	31	31	31	31	31	30	1	1	1
1	1	1	37	37	37	37	37	37	37	37	37	37	37	37	25	25	25	25	25	25	25	25	25	25	25	25	25	25	25	25	25	25	25	37	37	37	37	37	37	30	30	30	30	30	30	30	30	30	37	37	37	37	37	37	37	37	37	37	37	37	37	37	37	37	31	31	31	31	31	31	31	31	31	31	31	31	31	31	31	31	31	31	31	30	1	1	1	
1	1	1	37	37	37	37	37	37	37	37	37	37	37	37	25	25	25	25	25	25	25	25	25	25	25	25	25	25	25	25	25	25	25	37	37	37	37	37	37	30	30	30	30	30	30	30	30	30	37	37	37	37	37	37	37	37	37	37	37	37	37	37	37	37	31	31	0	31	31	31	31	31	31	31	31	31	31	31	31	31	0	31	31	30	1	1	1
1	1	1	37	37	37	37	37	37	37	37	37	37	37	37	25	25	25	25	25	25	25	25	25	25	25	25	25	25	25	25	25	25	25	37	37	37	37	37	37	30	30	30	30	30	30	30	30	30	25	25	25	25	25	25	25	25	25	25	25	25	25	25	25	25	25	25	25	38	37	37	37	37	37	37	37	37	37	37	37	37	37	37	37	34	1	1	1
1	1	1	37	37	37	37	37	37	37	37	37	37	37	37	25	25	25	25	38	38	38	38	38	38	38	38	38	38	38	25	25	25	25	37	37	37	37	37	37	30	30	30	30	30	30	30	30	30	25	25	25	25	25	25	25	25	25	25	25	25	25	25	25	25	25	25	25	38	37	37	37	37	37	37	37	37	37	37	37	37	37	37	37	34	1	1	1	
1	1	1	37	37	37	37	37	37	37	37	37	37	37	37	25	25	25	25	38	37	37	37	37	37	37	37	37	37	38	25	25	25	25	37	37	37	37	37	37	30	30	30	30	30	30	30	30	30	25	25	25	25	25	25	25	25	25	25	25	25	25	25	25	25	25	25	25	38	37	37	37	37	37	37	37	37	37	37	37	37	37	37	37	34	1	1	1
1	1	1	37	37	37	37	37	37	37	37	37	37	37	37	25	25	25	25	38	37	37	37	37	37	37	37	37	37	38	25	25	25	25	37	37	37	37	37	37	31	31	31	31	31	31	31	31	31	25	25	25	25	25	25	25	25	25	25	25	25	25	25	25	25	25	25	25	38	37	37	37	37	37	37	37	37	37	37	37	37	37	37	37	34	1	1	1
1	1	1	37	37	37	37	37	37	37	37	37	37	37	37	25	25	25	25	38	37	37	37	37	37	37	37	37	37	38	25	25	25	25	37	37	37	37	37	37	31	31	31	31	31	31	31	31	31	38	38	38	38	38	38	38	38	38	38	38	25	25	25	25	25	38	38	38	38	37	37	37	37	37	37	37	37	37	37	37	37	37	37	37	34	1	1	1
1	1	1	37	37	37	37	37	37	37	37	37	37	37	37	25	25	25	25	38	37	37	37	37	37	37	37	37	37	38	25	25	25	25	25	25	25	25	25	25	31	31	31	31	31	31	31	31	31	37	37	37	37	37	37	37	37	37	37	37	30	30	25	30	30	37	37	37	37	37	37	37	34	34	34	34	34	34	34	34	34	34	34	34	34	1	1	1
1	1	1	37	37	37	37	37	37	37	37	37	37	37	37	25	25	25	25	38	37	37	37	37	37	37	37	37	37	38	25	25	25	25	25	25	25	25	25	25	31	31	31	31	31	31	31	31	31	37	37	37	37	37	37	37	37	37	37	37	30	30	30	30	30	37	37	37	37	37	37	37	34	1	1	1	1	1	1	1	1	1	1	1	1	1	1	1	
1	1	1	37	37	37	37	37	37	37	37	37	37	37	37	25	25	25	25	38	37	37	30	30	37	30	30	37	37	38	25	25	25	25	25	25	25	25	25	25	31	31	31	31	31	31	31	31	31	37	37	37	37	37	37	37	37	37	37	37	30	30	30	30	30	37	37	37	37	37	37	37	34	1	1	1	1	1	1	1	1	1	1	1	1	1	1	1
1	1	1	37	37	37	37	37	37	37	37	37	37	37	37	25	25	25	25	38	37	37	30	30	30	30	30	37	37	38	25	25	25	25	25	25	25	25	25	25	31	31	31	31	31	31	31	31	31	37	37	37	37	37	37	37	37	37	37	37	30	30	30	30	30	37	37	37	37	37	37	37	34	1	1	1	1	1	1	1	1	1	1	1	1	1	1	1
1	1	1	37	37	37	37	37	37	37	37	37	37	37	37	25	25	25	25	38	37	37	30	30	30	30	30	37	37	38	38	38	38	38	38	38	38	38	38	38	31	31	31	31	31	31	31	31	31	37	37	37	37	37	37	37	37	37	37	37	30	30	30	30	30	37	37	37	37	37	37	37	34	1	1	1	1	1	1	1	1	1	1	1	1	1	1	1
1	1	1	37	37	37	37	37	37	37	37	37	37	37	37	25	25	25	25	38	37	37	30	30	30	30	30	37	37	37	37	37	37	37	37	37	37	37	37	37	31	31	31	31	31	31	31	31	31	37	37	37	37	37	37	37	37	37	37	37	31	31	31	31	31	37	37	37	37	37	37	37	34	1	1	1	1	1	1	1	1	1	1	1	1	1	1	1
1	1	1	37	37	37	37	37	37	37	37	37	37	37	37	25	25	25	25	38	37	37	30	30	30	30	30	37	37	37	37	37	37	37	37	37	37	37	37	37	37	37	37	37	37	37	37	37	37	37	37	37	37	37	37	37	37	37	37	37	31	31	31	31	31	37	37	37	37	37	37	37	34	1	1	1	1	1	1	1	1	1	1	1	1	1	1	1
1	1	1	37	37	37	37	37	37	37	37	37	37	37	37	25	25	25	25	38	37	37	30	30	30	30	30	37	37	37	37	37	37	37	37	37	37	37	37	37	37	37	37	37	37	37	37	37	37	37	37	37	37	37	37	37	37	37	37	37	31	31	31	31	31	37	37	37	37	37	37	37	34	1	1	1	1	1	1	1	1	1	1	1	1	1	1	1
1	1	1	37	37	37	37	37	37	37	37	37	37	37	37	25	25	25	25	38	37	37	31	31	31	31	31	37	37	37	37	37	37	37	37	37	37	37	37	37	37	37	37	37	37	37	37	37	37	37	37	37	37	37	37	37	37	37	37	37	37	37	37	37	37	37	37	37	37	37	37	37	34	1	1	1	1	1	1	1	1	1	1	1	1	1	1	1
1	1	1	37	37	37	37	37	37	37	37	37	37	37	37	25	25	25	25	38	37	37	31	31	31	31	31	37	37	37	37	37	37	37	37	37	37	37	37	37	37	37	37	37	37	37	37	37	37	37	37	37	37	37	37	37	37	37	37	37	37	37	37	37	37	37	37	37	37	37	37	37	34	1	1	1	1	1	1	1	1	1	1	1	1	1	1	1
1	1	1	37	37	37	37	37	37	37	37	37	37	37	37	25	25	25	25	38	37	37	31	31	31	31	31	37	37	37	37	37	37	37	37	37	37	37	37	37	37	37	37	37	37	37	37	37	37	37	37	37	37	37	37	37	37	37	37	37	37	37	37	37	37	37	37	37	37	37	37	37	34	1	1	1	1	1	1	1	1	1	1	1	1	1	1	1
1	1	1	37	37	37	37	37	37	37	37	37	37	37	37	25	25	25	25	38	37	37	37	37	37	37	37	37	37	37	37	37	37	37	37	37	37	37	37	37	37	37	37	37	37	37	37	37	37	37	37	37	37	37	37	37	37	37	37	37	37	37	37	37	37	37	37	37	37	37	37	37	34	1	1	1	1	1	1	1	1	1	1	1	1	1	1	1
1	1	1	37	37	37	37	37	37	37	37	37	37	37	37	25	25	25	25	38	37	37	37	37	37	37	37	37	37	37	37	37	37	37	37	37	37	37	37	37	37	37	37	37	37	37	37	37	37	37	37	37	37	37	37	37	37	37	37	37	37	37	37	37	37	37	37	37	37	37	37	37	34	1	1	1	1	1	1	1	1	1	1	1	1	1	1	1
1	1	1	37	37	37	37	37	37	37	37	37	37	37	37	25	25	25	25	38	37	37	37	37	37	37	37	37	37	37	37	37	37	37	37	37	37	37	37	37	37	37	37	37	37	37	37	37	37	37	37	37	37	37	37	37	37	37	37	37	37	37	37	37	37	37	37	37	37	37	37	37	34	1	1	1	1	1	1	1	1	1	1	1	1	1	1	1
1	1	1	37	37	37	37	37	37	37	37	37	37	37	37	25	25	25	25	38	37	37	37	37	37	37	37	37	37	37	37	37	37	37	37	37	37	37	37	37	37	37	37	37	37	37	37	37	37	37	37	37	37	37	37	37	37	37	37	37	37	37	37	37	37	37	37	37	37	37	37	37	34	1	1	1	1	1	1	1	1	1	1	1	1	1	1	1
1	1	1	37	37	37	37	37	37	37	37	37	37	37	37	25	25	25	25	38	38	38	38	38	38	38	38	38	38	38	38	38	38	38	38	38	38	38	38	38	38	38	38	38	38	37	37	37	37	37	37	37	37	37	37	37	37	37	37	37	37	37	37	37	37	37	37	37	37	37	37	37	34	1	1	1	1	1	1	1	1	1	1	1	1	1	1	1
1	1	1	37	37	37	37	37	37	37	37	37	37	37	37	25	25	25	25	25	25	25	25	25	25	25	25	25	25	25	25	25	25	25	25	25	25	25	25	25	25	25	25	25	38	37	37	37	37	37	37	37	37	37	37	37	37	37	37	37	37	37	37	37	37	37	37	37	37	37	37	37	34	1	1	1	1	1	1	1	1	1	1	1	1	1	1	1
1	1	1	37	37	37	37	37	37	37	37	37	37	37	37	25	25	25	25	25	25	25	25	25	25	25	25	25	25	25	25	25	25	25	25	25	25	25	25	25	25	25	25	25	38	37	37	37	37	37	37	37	37	37	37	37	37	37	37	37	37	37	37	37	37	37	37	37	37	37	37	37	34	1	1	1	1	1	1	1	1	1	1	1	1	1	1	1
1	1	1	37	37	37	37	37	37	37	37	37	37	37	37	25	25	25	25	25	25	25	25	25	25	25	25	25	25	25	25	25	25	25	25	25	25	25	25	25	25	25	25	25	38	37	37	37	37	37	37	37	37	37	37	37	37	37	37	37	37	37	37	37	37	37	37	37	37	37	37	37	34	1	1	1	1	1	1	1	1	1	1	1	1	1	1	1
1	1	1	37	37	37	37	37	37	37	37	37	37	37	37	25	25	25	25	25	25	25	25	25	25	25	25	25	25	25	25	25	25	25	38	38	38	38	38	38	38	38	38	38	38	37	37	37	37	37	37	37	37	37	37	37	37	37	37	37	37	37	37	37	37	37	37	37	37	34	34	34	34	1	1	1	1	1	1	1	1	1	1	1	1	1	1	1
1	1	1	37	37	37	37	37	37	37	37	37	37	37	37	37	37	37	37	37	37	37	37	37	37	37	37	37	37	25	25	25	25	38	37	37	37	37	37	37	37	37	37	37	37	37	37	37	37	37	37	37	37	37	37	37	37	37	37	37	37	37	37	37	37	37	37	34	34	34	1	1	1	1	1	1	1	1	1	1	1	1	1	1	1	1	1	1
1	1	1	37	37	37	37	37	37	37	37	37	37	37	37	37	37	37	37	37	37	37	37	37	37	37	37	37	37	25	25	25	25	38	37	37	37	37	37	37	37	37	37	37	37	37	37	37	37	37	37	37	37	37	37	37	37	37	34	34	34	34	34	34	34	34	34	34	1	1	1	1	1	1	1	1	1	1	1	1	1	1	1	1	1	1	1	1
1	1	1	37	37	37	37	37	37	37	37	37	37	37	37	37	37	37	37	37	37	37	37	37	37	37	37	37	37	25	25	25	25	38	37	37	37	37	37	37	37	37	37	37	37	37	37	37	37	37	37	37	37	37	37	37	37	37	35	35	35	35	35	35	34	1	1	1	1	1	1	1	1	1	1	1	1	1	1	1	1	1	1	1	1	1	1	1
1	1	1	37	37	37	37	37	37	37	37	37	37	37	37	37	37	37	37	37	37	37	37	37	37	37	37	37	37	25	25	25	25	38	37	37	37	37	37	37	37	37	37	37	37	37	37	37	37	37	37	37	37	37	37	37	37	37	35	35	35	35	35	35	34	1	1	1	1	1	1	1	1	1	1	1	1	1	1	1	1	1	1	1	1	1	1	1
1	1	1	37	37	37	37	37	37	37	37	37	37	37	37	37	37	37	37	37	37	37	37	37	37	37	37	37	37	25	25	25	25	38	37	37	37	37	37	37	37	37	37	37	37	37	37	37	37	37	37	37	37	37	37	37	37	37	35	35	35	35	35	35	34	1	1	1	1	1	1	1	1	1	1	1	1	1	1	1	1	1	1	1	1	1	1	1
1	1	1	37	37	37	37	37	37	37	37	37	37	37	37	37	37	37	37	37	37	37	37	37	37	37	37	37	37	25	25	25	25	38	37	37	37	37	37	37	37	37	37	37	37	37	37	37	37	37	37	37	37	37	37	37	37	37	35	35	35	35	35	35	34	1	1	1	1	1	1	1	1	1	1	1	1	1	1	1	1	1	1	1	1	1	1	1
1	1	1	37	37	37	37	37	37	37	37	37	37	37	37	37	37	37	37	37	37	37	37	37	37	37	37	37	37	25	25	25	25	38	37	37	37	37	37	37	37	37	37	37	37	37	37	37	37	37	37	37	37	37	37	37	37	37	35	35	35	35	35	35	34	1	1	1	1	1	1	1	1	1	1	1	1	1	1	1	1	1	1	1	1	1	1	1
1	1	1	37	37	37	37	37	37	37	37	37	37	37	37	37	37	37	37	37	37	37	37	37	37	37	37	37	37	25	25	25	25	38	37	37	37	37	37	37	37	37	37	37	37	37	37	37	37	37	37	37	37	37	37	37	37	37	37	37	37	37	37	37	34	1	1	1	1	1	1	1	1	1	1	1	1	1	1	1	1	1	1	1	1	1	1	1
1	1	1	37	37	37	37	37	37	37	37	37	37	37	37	37	37	37	37	37	37	37	37	37	37	37	37	37	37	25	25	25	25	38	37	37	37	37	37	37	37	37	37	37	37	37	37	37	37	37	37	37	37	37	37	37	37	37	37	37	37	37	37	37	34	1	1	1	1	1	1	1	1	1	1	1	1	1	1	1	1	1	1	1	1	1	1	1
1	1	1	37	37	37	37	37	37	37	37	37	37	37	37	37	37	37	37	37	37	37	37	37	37	37	37	37	37	25	25	25	25	38	37	37	37	37	37	37	37	37	37	37	37	37	37	37	37	37	37	37	37	37	37	37	37	37	37	37	37	37	37	37	34	1	1	1	1	1	1	1	1	1	1	1	1	1	1	1	1	1	1	1	1	1	1	1
1	1	1	37	37	37	37	37	37	37	37	37	37	37	37	37	37	37	37	37	37	37	37	37	37	37	37	37	37	25	25	25	25	38	37	37	37	37	37	37	37	37	37	37	37	37	37	37	37	37	37	37	37	37	37	37	37	37	37	37	37	37	37	37	34	1	1	1	1	1	1	1	1	1	1	1	1	1	1	1	1	1	1	1	1	1	1	1
1	1	1	37	37	37	37	37	37	37	37	37	37	37	37	37	37	37	37	37	37	37	37	37	37	37	37	37	37	25	25	25	25	38	37	37	37	37	37	37	37	37	37	37	37	37	37	37	37	37	37	37	37	37	37	37	37	37	37	37	37	37	37	37	34	1	1	1	1	1	1	1	1	1	1	1	1	1	1	1	1	1	1	1	1	1	1	1
1	1	1	37	37	37	37	37	37	37	37	37	37	37	37	37	37	37	37	37	37	37	37	37	37	37	37	37	37	25	25	25	25	38	37	37	37	37	37	37	37	37	37	37	37	37	37	37	37	37	37	37	37	37	37	37	37	37	37	37	37	37	37	37	34	1	1	1	1	1	1	1	1	1	1	1	1	1	1	1	1	1	1	1	1	1	1	1
1	1	1	37	37	37	37	37	37	37	37	37	37	37	37	37	37	37	37	37	37	37	37	37	37	37	37	37	37	25	25	25	25	38	37	37	37	37	37	37	37	37	37	37	37	37	37	37	37	37	37	37	37	37	37	37	37	37	37	37	37	37	37	37	34	1	1	1	1	1	1	1	1	1	1	1	1	1	1	1	1	1	1	1	1	1	1	1
1	1	1	37	37	37	37	37	37	37	37	37	37	37	37	37	37	37	37	37	37	37	37	37	37	37	37	37	37	25	25	25	25	38	37	37	37	37	37	37	37	37	37	37	37	37	37	37	37	37	37	37	37	37	37	37	37	37	37	37	37	37	37	37	34	1	1	1	1	1	1	1	1	1	1	1	1	1	1	1	1	1	1	1	1	1	1	1
1	1	1	37	37	37	37	37	37	37	37	37	37	37	37	37	37	37	37	37	37	37	37	37	37	37	37	37	37	25	25	25	25	38	37	37	37	37	37	37	37	37	37	37	37	37	37	37	37	37	37	37	37	37	37	37	37	37	37	37	37	37	37	37	34	1	1	1	1	1	1	1	1	1	1	1	1	1	1	1	1	1	1	1	1	1	1	1
1	1	1	37	37	37	37	37	37	37	37	37	37	37	37	37	37	37	37	37	37	37	37	37	37	37	37	37	37	25	25	25	25	38	37	37	37	37	37	37	37	37	37	37	37	37	37	37	37	37	37	37	37	37	37	37	37	37	37	37	37	37	37	37	34	1	1	1	1	1	1	1	1	1	1	1	1	1	1	1	1	1	1	1	1	1	1	1
1	1	1	37	37	37	37	37	37	37	37	37	37	37	37	37	37	37	37	37	37	37	37	37	37	37	37	37	37	25	25	25	25	38	37	37	37	37	37	37	37	37	37	37	37	37	37	37	37	37	37	37	37	37	37	37	37	37	37	37	37	37	37	37	34	1	1	1	1	1	1	1	1	1	1	1	1	1	1	1	1	1	1	1	1	1	1	1
1	1	1	37	37	37	37	37	37	37	37	37	37	37	37	37	37	37	37	37	37	37	37	37	37	37	37	37	37	25	25	25	25	38	37	37	37	37	37	37	37	37	37	37	37	37	37	37	37	37	37	37	37	37	37	37	37	37	37	37	37	37	37	37	34	1	1	1	1	1	1	1	1	1	1	1	1	1	1	1	1	1	1	1	1	1	1	1
1	1	1	37	37	37	37	37	37	37	37	37	37	37	37	37	37	37	37	37	37	37	37	37	37	37	37	37	37	25	25	25	25	38	37	37	37	37	37	37	37	37	37	37	37	37	37	37	37	37	37	37	37	37	37	37	37	37	37	37	37	37	37	37	34	1	1	1	1	1	1	1	1	1	1	1	1	1	1	1	1	1	1	1	1	1	1	1
1	1	1	37	37	37	37	37	37	37	37	37	37	37	37	37	37	37	37	37	37	37	37	37	37	37	37	37	30	30	30	25	30	30	30	37	37	37	37	37	37	37	37	37	37	37	37	37	37	37	37	37	37	37	37	37	37	37	37	37	37	37	37	37	34	1	1	1	1	1	1	1	1	1	1	1	1	1	1	1	1	1	1	1	1	1	1	1
1	1	1	37	37	37	37	37	37	37	37	37	37	37	37	37	37	37	37	37	37	37	37	37	37	37	37	37	30	30	30	30	30	30	30	37	37	37	37	37	37	37	37	37	37	37	37	37	37	37	37	37	37	37	37	37	37	37	37	37	37	37	37	37	34	1	1	1	1	1	1	1	1	1	1	1	1	1	1	1	1	1	1	1	1	1	1	1
1	1	1	37	37	37	37	37	37	37	37	37	37	37	37	37	37	37	37	37	37	37	37	37	37	37	37	37	30	30	30	30	30	30	30	37	37	37	37	37	37	37	37	37	37	37	37	37	37	37	37	37	37	37	37	37	37	37	37	37	37	37	37	37	34	1	1	1	1	1	1	1	1	1	1	1	1	1	1	1	1	1	1	1	1	1	1	1
1	1	1	37	37	37	37	37	37	37	37	37	37	37	37	37	37	37	37	37	37	37	37	37	37	37	37	37	30	30	30	30	30	30	30	37	37	37	37	37	37	37	37	37	37	37	37	37	37	37	37	37	37	37	37	37	37	37	37	37	37	37	37	37	34	1	1	1	34	34	34	34	34	34	1	1	1	1	1	1	1	1	1	1	1	1	1	1
1	1	1	37	37	37	37	37	37	37	37	37	37	37	37	37	37	37	37	37	37	37	37	37	37	37	37	37	30	30	30	30	30	30	30	37	37	37	37	37	37	37	37	37	37	37	37	37	37	37	37	37	37	37	37	37	37	37	37	37	37	37	37	37	34	1	1	34	34	34	1	1	1	1	1	1	1	1	1	1	1	1	1	1	1	1	1	1
1	1	1	37	37	37	37	37	37	37	37	37	37	37	37	37	37	37	37	37	37	37	37	30	30	30	30	30	30	30	30	30	30	30	30	30	30	30	30	30	30	30	30	30	30	30	30	30	30	30	30	30	30	30	30	30	30	30	34	34	34	34	34	34	34	34	34	34	1	1	1	1	1	1	1	1	1	1	1	1	1	1	1	1	1	1	1	1
1	1	1	37	37	37	37	37	37	37	37	37	37	37	37	37	37	37	37	37	37	37	37	30	30	30	30	30	30	30	30	30	30	30	30	30	30	30	30	30	1	1	1	1	1	1	1	1	1	1	1	1	1	1	1	1	1	1	1	1	1	1	1	1	1	1	1	1	1	1	1	1	1	1	1	1	1	1	1	1	1	1	1	1	1	1	1	1
1	1	1	37	37	37	37	37	37	37	37	37	37	37	37	37	37	37	37	37	37	37	37	30	30	30	30	30	30	30	30	30	30	30	30	30	30	30	30	30	1	1	1	1	1	1	1	1	1	1	1	1	1	1	1	1	1	1	1	1	1	1	1	1	1	1	1	1	1	1	1	1	1	1	1	1	1	1	1	1	1	1	1	1	1	1	1	1
1	1	1	37	37	37	37	37	37	37	37	37	37	37	37	37	37	37	37	37	37	37	37	30	30	30	30	30	30	30	30	30	30	30	30	30	30	30	30	30	1	1	1	1	1	1	1	1	1	1	1	1	1	1	1	1	1	1	1	1	1	1	1	1	1	1	1	1	1	1	1	1	1	1	1	1	1	1	1	1	1	1	1	1	1	1	1	1
1	1	1	37	37	37	37	37	37	37	37	37	37	37	37	37	37	37	37	37	37	37	37	30	30	30	30	30	30	30	30	30	30	30	30	30	30	30	30	30	1	1	1	1	1	1	1	1	1	1	1	1	1	1	1	1	1	1	1	1	1	1	1	1	1	1	1	1	1	1	1	1	1	1	1	1	1	1	1	1	1	1	1	1	1	1	1	1
1	1	1	37	37	37	37	37	37	37	37	37	37	37	37	37	37	37	37	37	37	37	37	30	30	30	30	30	30	30	30	30	30	30	30	30	30	30	30	30	1	1	1	1	1	1	1	1	1	1	1	1	1	1	1	1	1	1	1	1	1	1	1	1	1	1	1	1	1	1	1	1	1	1	1	1	1	1	1	1	1	1	1	1	1	1	1	1
1	1	1	37	37	37	37	37	37	37	37	37	37	37	37	37	37	37	37	37	37	37	37	30	30	30	30	30	30	30	30	30	30	30	30	30	30	30	30	30	1	1	1	1	1	1	1	1	1	1	1	1	1	1	1	1	1	1	1	1	1	1	1	1	1	1	1	1	1	1	1	1	1	1	1	1	1	1	1	1	1	1	1	1	1	1	1	1
1	1	1	1	1	1	1	1	1	1	1	1	1	1	1	1	1	1	1	1	1	1	1	1	1	1	1	1	1	1	1	1	1	1	1	1	1	1	1	1	1	1	1	1	1	1	1	1	1	1	1	1	1	1	1	1	1	1	1	1	1	1	1	1	1	1	1	1	1	1	1	1	1	1	1	1	1	1	1	1	1	1	1	1	1	1	1	1
1	1	1	1	1	1	1	1	1	1	1	1	1	1	1	1	1	1	1	1	1	1	1	1	1	1	1	1	1	1	1	1	1	1	1	1	1	1	1	1	1	1	1	1	1	1	1	1	1	1	1	1	1	1	1	1	1	1	1	1	1	1	1	1	1	1	1	1	1	1	1	1	1	1	1	1	1	1	1	1	1	1	1	1	1	1	1	1
1	1	1	1	1	1	1	1	1	1	1	1	1	1	1	1	1	1	1	1	1	1	1	1	1	1	1	1	1	1	1	1	1	1	1	1	1	1	1	1	1	1	1	1	1	1	1	1	1	1	1	1	1	1	1	1	1	1	1	1	1	1	1	1	1	1	1	1	1	1	1	1	1	1	1	1	1	1	1	1	1	1	1	1	1	1	1	1
418 24 24
419 81 16
62 896 1344
62 896 1440
62 896 1536
62 896 1632
62 896 1728
62 896 1824
62 896 1920
90 896 1176
88 1088 1152
88 1184 1152
90 1248 1176
88 832 1152
88 736 1152
88 640 1152
90 448 1176
62 448 1088
62 448 992
62 448 896
62 448 800
62 448 704
62 448 608
90 448 440
88 640 416
88 736 416
88 832 416
90 896 440
62 896 608
90 896 696
88 1088 672
88 1184 672
88 1568 512
88 1664 512
88 1760 512
88 1856 512
88 1952 512
90 2016 536
70 0 0;
15