11 14
5 9
4
0
0 0
1	1	1	1	1	1	1	1	1	1	1
1	1	1	1	1	1	1	1	1	1	1
1	1	1	1	1	1	1	1	1	1	1
1	1	1	16	16	16	16	16	1	1	1
1	1	1	16	17	17	17	16	1	1	1
1	1	1	16	17	17	17	16	1	1	1	
1	1	1	16	17	17	17	16	1	1	1	
1	1	1	16	14	14	14	16	1	1	1
1	1	1	16	14	14	14	16	1	1	1
1	1	1	16	14	14	14	16	1	1	1
1	1	1	16	16	16	16	16	1	1	1
1	1	1	1	1	1	1	1	1	1	1
1	1	1	1	1	1	1	1	1	1	1
1	1	1	1	1	1	1	1	1	1	1
1000 5 7
1001 4 6
1002 6 6
760 4 9
1