45 41
16 36
13
2
0 0
1	1	1	1	1	1	1	1	1	1	1	1	1	1	1	1	1	1	1	1	1	1	1	1	1	1	1	1	1	1	1	1	1	1	1	1	1	1	1	1	1	1	1	1	1
1	1	1	1	1	1	1	1	1	1	1	1	1	1	1	1	1	1	1	1	1	1	1	1	1	1	1	1	1	1	1	1	1	1	1	1	1	1	1	1	1	1	1	1	1
1	1	1	1	1	1	1	1	1	1	1	1	1	1	1	1	1	1	1	1	1	1	1	1	1	1	1	1	1	1	1	1	1	1	1	1	1	1	1	1	1	1	1	1	1
1	1	1	1	1	1	1	1	10	10	10	10	10	10	10	10	10	10	10	1	1	1	1	1	1	1	1	1	1	1	1	1	1	1	1	1	1	1	1	1	1	1	1	1	1	
1	1	1	1	1	1	1	1	10	11	11	11	11	11	11	11	11	11	10	1	1	1	1	1	1	1	1	1	1	1	1	1	1	1	1	1	1	1	1	1	1	1	1	1	1	
1	1	1	1	1	1	1	1	10	11	11	11	11	11	11	11	11	11	10	1	1	1	1	1	1	1	1	1	1	1	1	1	1	1	1	1	1	1	1	1	1	1	1	1	1	
1	1	1	1	1	1	1	1	10	11	11	11	11	0	11	11	11	11	10	1	1	1	1	1	1	1	1	1	1	1	1	1	1	1	1	1	1	1	1	1	1	1	1	1	1	
1	1	1	1	1	1	1	1	10	4	4	4	4	4	4	4	4	4	10	1	1	1	1	1	1	1	1	1	1	1	1	1	1	1	1	1	1	1	1	1	1	1	1	1	1	
1	1	1	1	1	1	1	1	10	4	4	4	4	4	4	4	4	4	10	1	1	1	1	1	1	1	1	1	1	1	1	1	1	1	1	1	1	1	1	1	1	1	1	1	1	
1	1	1	1	1	1	1	1	10	4	4	4	4	4	4	4	4	4	10	1	1	1	1	1	1	1	1	1	1	1	1	1	1	1	1	1	1	1	1	1	1	1	1	1	1	
1	1	1	1	1	1	1	1	10	4	4	4	4	4	4	4	4	4	10	1	1	1	1	1	1	1	1	1	1	1	1	1	1	1	1	1	1	1	1	1	1	1	1	1	1	
1	1	1	1	1	1	1	1	10	4	4	4	4	4	4	4	4	4	10	10	10	10	10	10	10	10	10	10	10	10	10	0	0	0	0	0	0	0	0	0	0	0	1	1	1	
1	1	1	1	1	1	1	1	10	4	4	4	4	4	4	4	4	4	11	11	11	11	11	11	11	11	11	11	11	11	10	0	0	0	0	0	0	0	0	0	0	0	1	1	1	
1	1	1	1	1	1	1	1	10	4	4	4	4	4	4	4	4	4	11	1	1	1	1	1	1	1	1	1	1	1	10	0	0	0	0	0	0	0	0	0	0	0	1	1	1	
1	1	1	10	10	10	10	10	10	4	4	4	4	4	4	4	4	4	11	1	1	1	1	1	1	1	1	1	1	1	10	0	0	0	0	0	0	0	0	0	0	0	1	1	1	
1	1	1	10	11	11	11	11	10	4	4	4	4	4	4	4	4	4	11	1	1	1	1	1	1	1	1	1	1	1	10	0	0	0	0	0	0	0	0	0	0	0	1	1	1
1	1	1	10	11	11	11	11	10	4	4	4	4	4	4	4	4	4	11	1	1	1	1	1	1	1	1	1	1	1	10	0	0	0	0	0	0	0	0	0	0	0	1	1	1
1	1	1	10	11	11	11	11	10	4	4	4	4	4	4	4	4	4	11	1	1	1	1	1	1	1	1	1	1	1	10	0	0	0	0	0	0	0	0	0	0	0	1	1	1
1	1	1	10	4	4	4	4	10	4	4	4	4	4	4	4	4	4	11	11	11	11	11	11	11	11	11	11	11	11	10	0	0	0	0	0	0	0	0	0	0	0	1	1	1
1	1	1	11	4	4	4	4	11	4	4	4	4	4	4	4	4	4	4	4	4	4	4	4	4	4	4	4	4	4	10	0	0	0	0	0	0	0	0	0	0	0	1	1	1
1	1	1	11	4	4	10	4	11	4	4	4	4	4	4	4	4	4	4	4	4	4	4	4	4	4	4	4	4	4	10	0	0	0	0	0	0	0	0	0	0	0	1	1	1
1	1	1	11	4	4	10	4	11	4	4	4	4	4	4	4	4	4	4	4	4	4	4	4	4	4	4	4	4	4	10	0	0	0	0	0	0	0	0	0	0	0	1	1	1
1	1	0	4	4	4	11	4	4	4	4	4	4	4	4	4	4	4	4	4	4	4	4	4	4	4	4	4	4	4	10	0	0	0	0	0	0	0	0	0	0	0	1	1	1
1	1	1	10	4	4	11	4	10	4	4	4	4	4	4	4	4	4	4	4	4	4	4	4	4	4	4	4	4	4	10	0	0	0	0	0	0	0	0	0	0	0	1	1	1
1	1	1	10	4	4	11	4	10	4	4	4	4	4	4	4	4	4	4	4	4	4	4	4	4	4	10	10	10	10	10	0	0	0	0	0	0	0	0	0	0	0	1	1	1	
1	1	1	10	4	4	4	4	10	4	4	4	4	4	4	4	4	4	4	4	4	4	4	4	4	4	10	0	0	0	0	0	0	0	0	0	0	0	0	0	0	0	1	1	1	
1	1	1	10	4	4	4	4	10	4	4	4	4	4	4	4	4	4	4	4	4	4	4	4	4	4	10	0	0	0	0	0	0	0	0	0	0	0	0	0	0	0	1	1	1	
1	1	1	10	10	10	10	10	10	4	4	4	4	4	4	4	4	4	4	4	4	4	4	4	4	4	10	0	0	0	0	0	0	0	0	0	0	0	0	0	0	0	1	1	1	
1	1	1	1	1	1	1	1	10	4	4	4	4	4	4	4	4	4	4	4	4	4	4	4	4	4	10	0	0	0	0	0	0	0	0	0	0	0	0	0	0	0	1	1	1	
1	1	1	1	1	1	1	1	10	4	4	4	4	4	4	4	4	4	4	4	4	4	4	4	4	4	10	0	0	0	0	0	0	0	0	0	0	0	1	1	1	1	1	1	1	
1	1	1	1	1	1	1	1	10	4	4	4	4	4	4	4	4	4	4	4	4	4	4	4	4	4	10	0	0	0	0	0	0	0	0	0	0	0	1	1	1	1	1	1	1	
1	1	1	1	1	1	1	1	10	4	4	4	4	4	4	4	4	4	4	4	4	4	4	4	4	4	10	0	0	0	0	0	0	0	0	0	0	0	1	1	1	1	1	1	1	
1	1	1	1	1	1	1	1	10	10	10	10	10	10	4	4	4	4	4	10	10	10	10	10	10	10	10	0	0	0	0	0	0	0	0	0	0	0	1	1	1	1	1	1	1	
1	1	1	1	1	1	1	1	1	1	1	1	1	10	4	4	4	4	4	10	1	1	1	1	1	1	1	0	0	0	0	0	0	0	0	0	0	0	1	1	1	1	1	1	1	
1	1	1	1	1	1	1	1	1	1	1	1	1	10	4	4	4	4	4	10	1	1	1	1	1	1	1	0	0	0	0	0	0	0	0	0	0	0	1	1	1	1	1	1	1		
1	1	1	1	1	1	1	1	1	1	1	1	1	10	4	4	4	4	4	10	1	1	1	1	1	1	1	0	0	0	0	0	0	0	0	0	0	0	1	1	1	1	1	1	1	
1	1	1	1	1	1	1	1	1	1	1	1	1	10	10	10	4	10	10	10	1	1	1	1	1	1	1	1	1	1	1	1	1	1	1	1	1	1	1	1	1	1	1	1	1	
1	1	1	1	1	1	1	1	1	1	1	1	1	1	1	1	0	1	1	1	1	1	1	1	1	1	1	1	1	1	1	1	1	1	1	1	1	1	1	1	1	1	1	1	1	
1	1	1	1	1	1	1	1	1	1	1	1	1	1	1	1	1	1	1	1	1	1	1	1	1	1	1	1	1	1	1	1	1	1	1	1	1	1	1	1	1	1	1	1	1	
1	1	1	1	1	1	1	1	1	1	1	1	1	1	1	1	1	1	1	1	1	1	1	1	1	1	1	1	1	1	1	1	1	1	1	1	1	1	1	1	1	1	1	1	1	
1	1	1	1	1	1	1	1	1	1	1	1	1	1	1	1	1	1	1	1	1	1	1	1	1	1	1	1	1	1	1	1	1	1	1	1	1	1	1	1	1	1	1	1	1	
1003 17 30
1003 18 30
1003 19 30
1004 20 30
1004 20 29
1004 20 28
1004 20 27
1004 21 27
1004 22 27
1004 23 27
1004 24 27
1004 25 27
1004 25 26
1000 320 288
72 0 0
1
	