

2   2   181 182 182 182 182 182 182 182 182 182 182 182 182 182 182 182
2   2   186 170 170 170 170 170 170 170 170 170 170 170 170 170 170 170
2   2   186 176 176 176 176 176 1   176 176 176 176 176 1   176 176 176
2   2   186 71  72  72  72  72  75  72  72  72  72  72  75  72  72  72 
2   2   186 74  75  75  75  75  75  75  75  75  75  75  75  75  75  75
2   2   186 74  75  75  75  75  75  75  75  75  75  75  75  75  75  75
2   2   186 74  75  75  75  75  75  75  75  75  75  75  75  75  75  75
2   2   186 74  75  75  75  75  75  75  75  75  75  75  75  75  75  75
2   2   186 77  78  78  78  78  75  75  78  78  78  78  78  78  75  75
2   2   187 188 188 188 188 183 74  76  181 188 188 188 188 183 1   183 183 183 183 183
2   2   2   2   2   2   2   186 74  76  184 2   2   2   2   2   2   2
2   2   2   2   2   2   2   186 74  76  184 2   2   2   2   2   2   2
2   2   2   2   2   2   2   186 74  76  184 2   2   2   2   2   2   2
2   2   2   2   2   176 170 170 74  76  184 2   2   2   2   2   2   2
2   2   2   2   1   196 176 170 74  76  184 2   2   2   2   2   2   2
2   2   2   2   1   196 196 176 74  76  184 2   2   2   2   2   2   2
2   2   2   2   2   2   196 196 75  76  184 2   2   2   2   2   2   2
2   2   2   2   2   2   2   196 75  76  184 2   2   2   2   2   2   2
181	182	182	182	182	182	182	182	75	76	184 2   2   2   2   2   2   2
186	170	170	170	170	170	170	170	74	76	184 2   2   2   2   2   2   2
186	176	176	176	176	176	176	176	74	76	184 2   2   2   2   2   2   2
186	71	72	72	72	72	72	72	75	76	184 2   2   2   2   2   2   2
186	74	75	75	75	75	75	75	75	76	184 2   2   2   2   2   2   2
186	74	75	75	75	75	75	75	75	76	184 2   2   2   2   2   2   2
186	74	75	75	75	75	75	75	75	76	170 2   2   2   2   2   2   2
186	74	75	75	75	75	75	75	75	76	176	2   2   2   2   2   2   2
186	74	75	75	75	75	75	75	75	75	75	2   2   2   2   2   2   2
186	77	78	78	78	78	78	78	78	79	184 2   2   2   2   2   2   2
187	182	182	182	182	182	182	182	182	182	189 2   2   2   2   2   2   2   2   2   2   2   2   2   2
2   2   2   2   2   2   2   2   2   2   2   2   2   2   2   2   2   2   2   2   2