






181	182	182	182	182	182	182	182	75	76	184
186	170	170	170	170	170	170	170	75	76	184
186	176	176	176	176	176	176	176	75	76	184
186	71	72	72	72	72	72	72	75	76	184
186	74	75	75	75	75	75	75	75	76	184
186	74	75	75	75	75	75	75	75	76	184
186	74	75	75	75	75	75	75	75	76	184
186	74	75	75	75	75	75	75	75	76	184	
186	74	75	75	75	75	75	75	75	75	75	
186	77	78	78	78	78	78	78	78	79	184
187	182	182	182	182	182	182	182	182	182	189