36 44
11 37						
3					
0
0 0					
1	1	1	1	1	1	1	1	1	1	1	1	1	1	1	1	1	1	1	1	1	1	1	1	1	1	1	1	1	1	1	1	1	1	1	1
1	1	1	1	1	1	1	1	1	1	1	1	1	1	1	1	1	1	1	1	1	1	1	1	1	1	1	1	1	1	1	1	1	1	1	1
1	1	1	1	1	1	1	1	1	1	1	1	1	1	1	1	1	1	1	1	1	1	1	1	1	1	1	1	1	1	1	1	1	1	1	1
1	1	1	1	30	30	30	30	30	30	30	30	30	30	30	30	30	30	30	30	1	1	1	1	1	1	1	1	1	1	1	1	1	1	1	1
1	1	1	1	30	31	31	31	31	31	31	31	31	31	31	31	31	31	31	30	1	1	1	1	1	1	1	1	1	1	1	1	1	1	1	1
1	1	1	1	30	31	31	31	31	31	31	31	31	31	31	31	31	31	31	30	1	1	1	1	1	1	1	1	1	1	1	1	1	1	1	1
1	1	1	1	30	31	31	31	31	31	31	31	31	31	31	31	31	31	31	30	1	1	1	1	1	1	1	1	1	1	1	1	1	1	1	1
1	1	1	1	30	41	41	41	41	41	41	41	41	41	41	41	41	41	41	30	1	1	1	1	1	1	1	1	1	1	1	1	1	1	1	1
1	1	1	1	30	41	41	41	41	41	41	41	41	41	41	41	41	41	41	30	1	1	1	1	1	1	1	1	1	1	1	1	1	1	1	1
1	1	1	1	30	41	41	41	41	41	41	41	41	41	41	41	41	41	41	30	1	1	1	1	1	1	1	1	1	1	1	1	1	1	1	1
1	1	1	1	30	41	41	41	41	41	41	41	41	41	41	41	41	41	41	30	1	1	1	1	1	1	1	1	1	1	1	1	1	1	1	1
1	1	1	1	30	41	41	41	41	41	41	41	41	41	41	41	41	41	41	30	1	1	1	1	1	1	1	1	1	1	1	1	1	1	1	1
1	1	1	1	30	41	41	41	41	41	41	41	41	41	41	41	41	41	41	30	1	1	1	1	1	1	1	1	1	1	1	1	1	1	1	1
1	1	1	1	30	41	41	41	41	41	41	41	41	41	41	41	41	41	41	30	1	1	1	1	1	1	1	1	1	1	1	1	1	1	1	1
1	1	1	1	30	41	41	41	41	41	41	41	41	41	41	41	41	41	41	30	1	1	1	1	1	1	1	1	1	1	1	1	1	1	1	1
1	1	1	1	30	41	41	41	41	41	41	41	41	30	41	41	41	41	41	30	1	1	1	1	30	30	30	30	30	30	30	30	30	1	1	1
1	1	1	30	30	41	41	41	30	30	30	30	30	30	41	41	41	41	41	30	1	1	1	1	30	31	31	31	31	31	31	31	30	1	1	1
1	1	1	30	31	41	41	41	31	31	31	30	31	31	41	41	41	41	41	30	1	1	1	1	30	31	31	31	31	31	31	31	30	1	1	1
1	1	1	30	31	41	41	41	31	31	31	30	31	31	41	41	41	41	41	30	30	30	30	30	30	31	31	31	31	31	31	31	30	1	1	1
1	1	1	30	31	41	41	41	31	31	31	30	31	31	41	41	41	41	41	31	31	31	31	31	31	41	41	41	41	41	41	41	30	1	1	1
1	1	1	30	41	41	41	41	41	41	41	30	41	41	41	41	41	41	41	31	31	31	31	31	31	41	41	41	41	41	41	41	30	1	1	1
1	1	1	30	41	41	41	41	41	41	41	30	41	41	41	41	41	41	41	31	31	31	31	31	31	41	41	41	41	41	41	41	30	1	1	1
1	1	1	30	41	41	41	41	41	41	41	30	41	41	41	41	41	41	41	41	41	41	41	41	41	41	41	41	41	41	41	41	30	1	1	1
1	1	1	30	41	41	41	41	41	41	41	30	41	41	41	41	41	41	41	41	41	41	41	41	41	41	41	41	41	41	41	41	30	1	1	1
1	1	1	30	41	41	41	41	41	41	41	30	41	41	41	41	41	41	41	41	41	41	41	41	41	41	41	41	41	41	41	41	30	1	1	1
1	1	1	30	41	41	41	41	41	41	41	30	41	41	41	41	41	41	41	41	41	41	41	41	41	41	41	41	41	41	41	41	30	1	1	1
1	1	1	30	41	41	41	41	41	41	41	30	41	41	41	41	41	41	41	41	41	41	41	41	41	41	41	41	41	41	41	41	30	1	1	1
1	1	1	30	41	41	41	41	41	41	41	30	41	41	41	41	41	41	30	30	30	30	30	30	30	41	41	41	41	41	41	41	30	1	1	1
1	1	1	30	41	41	41	41	41	41	41	30	41	41	41	41	41	41	30	1	1	1	1	1	30	41	41	41	41	41	41	41	30	1	1	1
1	1	1	30	41	41	41	41	41	41	41	30	41	41	41	41	41	41	30	1	1	1	1	1	30	41	41	41	41	41	41	41	30	1	1	1
1	1	1	30	41	41	41	41	41	41	41	30	41	41	30	30	30	30	30	1	1	1	1	1	30	41	41	41	41	41	41	41	30	1	1	1
1	1	1	30	41	41	41	41	41	41	41	30	30	30	30	1	1	1	1	1	1	1	1	1	30	41	41	41	41	41	41	41	30	1	1	1
1	1	1	30	41	41	41	41	41	41	41	30	1	1	1	1	1	1	1	1	1	1	1	1	30	30	30	30	41	30	30	30	30	1	1	1
1	1	1	30	30	30	30	30	41	41	41	30	1	1	1	1	1	1	1	1	1	1	1	1	1	1	1	1	0	1	1	1	1	1	1	1
1	1	1	1	1	1	1	30	41	41	41	30	1	1	1	1	1	1	1	1	1	1	1	1	1	1	1	1	1	1	1	1	1	1	1	1
1	1	1	1	1	1	1	30	41	41	41	31	1	1	1	1	1	1	1	1	1	1	1	1	1	1	1	1	1	1	1	1	1	1	1	1
1	1	1	1	1	1	1	30	41	41	41	31	1	1	1	1	1	1	1	1	1	1	1	1	1	1	1	1	1	1	1	1	1	1	1	1
1	1	1	1	1	1	1	30	41	41	41	31	1	1	1	1	1	1	1	1	1	1	1	1	1	1	1	1	1	1	1	1	1	1	1	1
1	1	1	1	1	1	1	30	41	41	41	41	0	1	1	1	1	1	1	1	1	1	1	1	1	1	1	1	1	1	1	1	1	1	1	1
1	1	1	1	1	1	1	30	41	41	41	30	1	1	1	1	1	1	1	1	1	1	1	1	1	1	1	1	1	1	1	1	1	1	1	1
1	1	1	1	1	1	1	30	30	30	30	30	1	1	1	1	1	1	1	1	1	1	1	1	1	1	1	1	1	1	1	1	1	1	1	1
1	1	1	1	1	1	1	1	1	1	1	1	1	1	1	1	1	1	1	1	1	1	1	1	1	1	1	1	1	1	1	1	1	1	1	1
1	1	1	1	1	1	1	1	1	1	1	1	1	1	1	1	1	1	1	1	1	1	1	1	1	1	1	1	1	1	1	1	1	1	1	1
1	1	1	1	1	1	1	1	1	1	1	1	1	1	1	1	1	1	1	1	1	1	1	1	1	1	1	1	1	1	1	1	1	1	1	1
390 12 38
391 28 33
392 17 6
4