30 47
5 42
1
1
0 0
1	1	1	1	1	1	1	1	1	1	1	1	1	1	1	1	1	1	1	1	1	1	1	1	1	1	1	1	1	1
1	1	1	1	1	1	1	1	1	1	1	1	1	1	1	1	1	1	1	1	1	1	1	1	1	1	1	1	1	1
1	1	1	1	1	1	1	1	1	1	1	1	1	1	1	1	1	1	1	1	1	1	1	1	1	1	1	1	1	1
1	1	1	1	1	1	1	1	1	1	1	1	1	1	1	1	1	1	30	30	30	30	30	30	30	30	30	1	1	1
1	1	1	1	1	1	1	1	1	1	1	1	1	1	1	1	1	1	30	31	31	31	31	31	31	31	30	1	1	1	
1	1	1	30	30	30	30	30	30	30	30	1	1	1	1	1	1	1	30	31	31	31	31	31	31	31	30	1	1	1	
1	1	1	30	31	31	31	31	31	31	30	30	30	30	30	30	1	1	30	31	31	31	31	31	31	31	30	1	1	1	
1	1	1	30	31	31	31	31	31	31	31	31	31	31	31	30	1	1	30	41	41	41	41	41	41	41	30	1	1	1
1	1	1	30	31	31	31	31	31	31	31	31	31	31	31	30	1	1	30	41	41	41	41	41	41	41	30	1	1	1
1	1	1	30	41	41	41	41	41	41	31	31	31	31	31	30	1	1	30	41	41	41	41	41	41	41	30	1	1	1
1	1	1	30	41	41	41	41	41	41	41	41	41	41	41	30	1	1	30	41	41	41	41	41	41	41	30	1	1	1
1	1	1	30	41	41	41	41	41	41	41	41	41	41	41	30	1	1	30	41	41	41	41	41	41	41	30	1	1	1
1	1	1	30	41	41	41	41	41	41	41	41	41	41	41	30	1	1	30	41	41	41	41	41	41	41	30	1	1	1
1	1	1	30	41	41	41	41	41	41	30	41	41	41	41	30	1	1	30	41	41	41	41	41	41	41	30	1	1	1
1	1	1	30	30	30	30	41	41	41	30	30	30	30	30	30	30	30	30	30	30	41	41	41	30	30	30	1	1	1
1	1	1	30	31	31	31	41	41	41	31	31	31	31	31	31	31	31	31	31	31	41	41	41	30	1	1	1	1	1
1	1	1	30	31	31	31	41	41	41	31	31	31	31	31	31	31	31	31	31	31	41	41	41	30	1	1	1	1	1
1	1	1	30	31	31	31	41	41	41	31	31	31	31	31	31	31	31	31	31	31	41	41	41	30	1	1	1	1	1
1	1	1	30	41	41	41	41	41	41	41	41	41	41	41	41	41	41	41	41	41	41	41	41	30	1	1	1	1	1
1	1	1	30	41	41	41	41	41	41	41	41	41	41	41	41	41	41	41	41	41	41	41	41	30	1	1	1	1	1
1	1	1	30	41	41	41	41	41	41	41	41	41	41	41	41	41	41	41	41	41	41	41	41	30	1	1	1	1	1
1	1	1	30	41	41	41	41	41	41	41	41	41	41	41	41	41	41	41	41	41	41	41	41	30	1	1	1	1	1
1	1	1	30	41	41	41	41	41	41	41	41	41	41	41	41	41	41	41	41	41	41	41	41	30	1	1	1	1	1
1	1	1	30	41	41	41	41	41	41	41	41	41	41	41	41	41	41	41	41	41	41	41	41	30	1	1	1	1	1
1	1	1	30	41	41	41	41	41	41	41	41	41	41	41	41	41	41	41	41	41	41	41	41	30	1	1	1	1	1
1	1	1	30	41	41	41	30	30	30	30	30	30	30	30	30	30	30	30	30	30	41	41	41	30	1	1	1	1	1
1	1	1	30	41	41	41	30	1	1	1	1	1	30	31	31	31	31	31	31	31	41	41	41	30	1	1	1	1	1
1	1	1	30	41	41	41	30	1	1	1	1	1	30	31	31	31	31	31	31	31	41	41	41	30	1	1	1	1	1
1	1	1	30	41	41	41	30	30	30	30	30	30	30	31	31	31	31	31	31	31	41	41	41	30	1	1	1	1	1
1	1	1	30	41	41	41	31	31	31	31	31	31	31	41	41	41	41	41	41	41	41	41	41	30	1	1	1	1	1
1	1	1	30	41	41	41	31	31	31	31	31	31	31	41	41	41	41	41	41	41	41	41	41	30	1	1	1	1	1
1	1	1	30	41	41	41	31	31	31	31	31	31	31	41	41	41	41	41	41	41	41	41	41	30	1	1	1	1	1
1	1	1	30	41	41	41	41	41	41	41	41	41	41	41	41	41	30	30	30	30	41	41	41	30	1	1	1	1	1
1	1	1	30	41	41	41	41	41	41	41	41	41	41	41	41	41	30	31	31	31	41	41	41	30	1	1	1	1	1
1	1	1	30	41	41	41	41	41	41	41	41	41	41	41	41	41	30	31	31	31	41	41	41	30	1	1	1	1	1
1	1	1	30	41	41	41	30	41	41	41	30	30	30	30	30	30	30	31	31	31	41	41	41	30	1	1	1	1	1
1	1	1	30	41	41	41	30	41	41	41	31	31	31	31	31	31	31	41	41	41	41	41	41	30	1	1	1	1	1
1	1	1	30	41	41	41	30	41	41	41	31	31	31	31	31	31	31	41	41	41	41	41	41	30	1	1	1	1	1
1	1	1	30	41	41	41	30	41	41	41	31	31	31	31	31	31	31	41	41	41	41	41	41	30	1	1	1	1	1
1	1	1	30	41	41	41	30	41	41	41	41	41	41	41	41	41	41	41	41	41	30	30	30	30	1	1	1	1	1
1	1	1	30	41	41	41	30	41	41	41	41	41	41	41	41	41	41	41	41	41	30	1	1	1	1	1	1	1	1
1	1	1	30	41	41	41	30	41	41	41	41	41	41	41	41	41	41	41	41	41	30	1	1	1	1	1	1	1	1
1	1	1	30	30	41	30	30	30	30	30	30	30	30	30	30	30	30	30	30	30	30	1	1	1	1	1	1	1	1
1	1	1	1	1	0	1	1	1	1	1	1	1	1	1	1	1	1	1	1	1	1	1	1	1	1	1	1	1	1
1	1	1	1	1	1	1	1	1	1	1	1	1	1	1	1	1	1	1	1	1	1	1	1	1	1	1	1	1	1
1	1	1	1	1	1	1	1	1	1	1	1	1	1	1	1	1	1	1	1	1	1	1	1	1	1	1	1	1	1
1	1	1	1	1	1	1	1	1	1	1	1	1	1	1	1	1	1	1	1	1	1	1	1	1	1	1	1	1	1
393 5 43
73 0 0
5
