24 35
17 30
16
17
0 0
1	1	1	1	1	1	1	1	1	1	1	1	1	1	1	1	1	1	1	1	1	1	1	1
1	1	1	1	1	1	1	1	1	1	1	1	1	1	1	1	1	1	1	1	1	1	1	1
1	1	1	32	32	32	32	32	32	32	32	32	32	32	32	32	1	1	1	1	1	1	1	1
1	1	1	32	33	33	33	33	33	33	33	33	33	33	33	33	1	1	1	1	1	1	1	1
1	1	1	32	33	33	33	33	33	33	33	33	33	33	33	33	1	1	1	1	1	1	1	1
1	1	1	32	33	33	33	33	33	33	33	33	33	33	33	33	1	1	1	1	1	1	1	1
1	1	1	32	26	26	26	26	26	26	26	26	26	26	26	26	1	1	1	1	1	1	1	1
1	1	1	32	26	26	26	26	26	26	26	26	26	26	26	26	21	1	1	1	1	1	1	1
1	1	1	32	26	26	26	26	26	26	26	26	26	26	26	32	1	21	1	1	1	1	1	1
1	1	1	32	26	26	26	26	26	26	26	26	26	26	26	32	1	1	21	26	26	1	1	1
1	1	1	32	26	26	26	26	26	26	26	26	26	26	26	32	1	1	1	26	26	1	1	1
1	1	1	32	26	26	26	26	26	26	26	26	32	32	32	32	1	1	1	1	18	1	1	1
1	1	1	32	26	26	26	26	26	26	26	26	32	1	1	1	1	1	1	1	18	1	1	1
1	1	1	32	26	26	26	26	26	26	26	26	32	1	1	1	1	1	1	1	18	1	1	1
1	1	1	32	26	26	26	26	26	26	26	26	32	1	1	1	1	1	1	1	18	1	1	1
1	1	1	32	26	26	26	26	26	26	26	26	32	1	1	1	1	1	1	1	18	1	1	1
1	1	1	32	26	26	26	26	26	26	26	26	32	1	1	1	1	1	1	1	18	1	1	1
1	1	1	32	26	26	26	26	26	26	26	26	32	32	32	32	32	32	32	1	18	1	1	1
1	1	1	32	26	26	26	26	26	26	26	26	33	33	33	33	33	33	32	1	0	1	1	1
1	1	1	32	26	26	26	26	26	26	26	26	33	33	33	33	33	33	32	1	1	1	1	1
1	1	1	32	26	26	26	26	26	26	26	26	33	33	33	33	33	33	32	1	1	1	1	1
1	1	1	32	26	26	26	26	26	26	26	26	26	26	26	26	26	26	32	1	1	1	1	1
1	1	1	32	26	26	26	26	26	26	26	26	26	26	26	26	26	26	32	1	1	1	1	1
1	1	1	32	26	26	26	26	26	26	26	26	26	26	26	26	26	26	32	1	1	1	1	1
1	1	1	32	26	26	26	26	26	26	26	26	26	26	26	26	26	26	32	1	1	1	1	1
1	1	1	32	26	26	26	26	26	26	26	26	26	26	26	26	26	26	32	1	1	1	1	1
1	1	1	32	26	26	26	26	26	26	26	26	26	26	26	26	26	26	32	1	1	1	1	1
1	1	1	32	26	26	26	26	26	26	26	26	26	26	26	26	26	26	32	1	1	1	1	1
1	1	1	32	32	32	32	32	32	32	32	32	32	32	32	32	18	18	32	1	1	1	1	1
1	1	1	1	1	1	1	1	1	1	1	1	1	1	1	1	18	18	1	1	1	1	1	1
1	1	1	1	1	1	1	1	1	1	1	1	1	1	1	1	18	18	1	1	1	1	1	1
1	1	1	1	1	1	1	1	1	1	1	1	1	1	1	1	0	0	1	1	1	1	1	1
1	1	1	1	1	1	1	1	1	1	1	1	1	1	1	1	1	1	1	1	1	1	1	1
1	1	1	1	1	1	1	1	1	1	1	1	1	1	1	1	1	1	1	1	1	1	1	1
1	1	1	1	1	1	1	1	1	1	1	1	1	1	1	1	1	1	1	1	1	1	1	1
404 16 31
404 17 31
405 7 5
406 20 18
682 6 23
683 8 12
684 14 8
714 16 24
56 16 23
101 13 21
101 13 22
101 13 23
101 13 24
101 14 24
101 15 24
101 17 24
10 416 672
13 416 704
13 416 736
16 416 768
17 448 768
17 480 768
17 512 768
18 544 768
36 512 192
36 544 224
36 576 256
37 512 224
37 544 256
37 576 288
95 512 256
95 544 288
95 576 320
4