24 35
17 30
4
12
0 0
1	1	1	1	1	1	1	1	1	1	1	1	1	1	1	1	1	1	1	1	1	1	1	1
1	1	1	1	1	1	1	1	1	1	1	1	1	1	1	1	1	1	1	1	1	1	1	1
1	1	1	32	32	32	32	32	32	32	32	32	32	32	32	32	1	1	1	1	1	1	1	1
1	1	1	32	33	33	33	33	33	33	33	33	33	33	33	33	1	1	1	1	1	1	1	1
1	1	1	32	33	33	33	33	33	33	33	33	33	33	33	33	1	1	1	1	1	1	1	1
1	1	1	32	33	33	33	33	33	33	33	33	33	33	33	33	1	1	1	1	1	1	1	1
1	1	1	32	26	26	26	26	26	26	26	26	26	26	26	26	1	1	1	1	1	1	1	1
1	1	1	32	26	26	26	26	26	26	26	26	26	26	26	26	21	1	1	1	1	1	1	1
1	1	1	32	26	26	26	26	26	26	26	26	26	26	26	32	1	21	1	1	1	1	1	1
1	1	1	32	26	26	26	26	26	26	26	26	26	26	26	32	1	1	21	26	26	1	1	1
1	1	1	32	26	26	26	26	26	26	26	26	26	26	26	32	1	1	1	26	26	1	1	1
1	1	1	32	26	26	26	26	26	26	26	26	32	32	32	32	1	1	1	1	18	1	1	1
1	1	1	32	26	26	26	26	26	26	26	26	32	1	1	1	1	1	1	1	18	1	1	1
1	1	1	32	26	26	26	26	26	26	26	26	32	1	1	1	1	1	1	1	18	1	1	1
1	1	1	32	26	26	26	26	26	26	26	26	32	1	1	1	1	1	1	1	18	1	1	1
1	1	1	32	26	26	26	26	26	26	26	26	32	1	1	1	1	1	1	1	18	1	1	1
1	1	1	32	26	26	26	26	26	26	26	26	32	1	1	1	1	1	1	1	18	1	1	1
1	1	1	32	26	26	26	26	26	26	26	26	32	32	32	32	32	32	32	1	18	1	1	1
1	1	1	32	26	26	26	26	26	26	26	26	33	33	33	33	33	33	32	1	0	1	1	1
1	1	1	32	26	26	26	26	26	26	26	26	33	33	33	33	33	33	32	1	1	1	1	1
1	1	1	32	26	26	26	26	26	26	26	26	33	33	33	33	33	33	32	1	1	1	1	1
1	1	1	32	26	26	26	26	26	26	26	26	26	26	26	26	26	26	32	1	1	1	1	1
1	1	1	32	26	26	26	26	26	26	26	26	26	26	26	26	26	26	32	1	1	1	1	1
1	1	1	32	26	26	26	26	26	26	26	26	26	26	26	26	26	26	32	1	1	1	1	1
1	1	1	32	26	26	26	26	26	26	26	26	26	26	26	26	26	26	32	1	1	1	1	1
1	1	1	32	26	26	26	26	26	26	26	26	26	26	26	26	26	26	32	1	1	1	1	1
1	1	1	32	26	26	26	26	26	26	26	26	26	26	26	26	26	26	32	1	1	1	1	1
1	1	1	32	26	26	26	26	26	26	26	26	26	26	26	26	26	26	32	1	1	1	1	1
1	1	1	32	32	32	32	32	32	32	32	32	32	32	32	32	18	18	32	1	1	1	1	1
1	1	1	1	1	1	1	1	1	1	1	1	1	1	1	1	18	18	1	1	1	1	1	1
1	1	1	1	1	1	1	1	1	1	1	1	1	1	1	1	18	18	1	1	1	1	1	1
1	1	1	1	1	1	1	1	1	1	1	1	1	1	1	1	0	0	1	1	1	1	1	1
1	1	1	1	1	1	1	1	1	1	1	1	1	1	1	1	1	1	1	1	1	1	1	1
1	1	1	1	1	1	1	1	1	1	1	1	1	1	1	1	1	1	1	1	1	1	1	1
1	1	1	1	1	1	1	1	1	1	1	1	1	1	1	1	1	1	1	1	1	1	1	1
404 16 31
404 17 31
405 7 5
406 20 18
36 512 192
36 544 224
36 576 256
37 512 224
37 544 256
37 576 288
38 512 256
38 544 288
38 576 320
39 512 288
39 544 320
39 512 320
4