22 26
9 21
14
8
0 0
1	1	1	1	1	1	1	1	1	1	1	1	1	1	1	1	1	1	1	1	1	1
1	1	1	1	1	1	1	1	1	1	1	1	1	1	1	1	1	1	1	1	1	1
1	1	1	1	1	1	1	1	1	1	1	1	1	1	1	1	1	1	1	1	1	1
1	1	1	1	1	1	1	1	1	1	1	1	1	1	1	1	0	0	1	1	1	1
1	1	1	32	32	32	32	32	32	32	32	32	32	32	32	32	18	18	32	1	1	1
1	1	1	32	33	33	33	33	33	33	33	33	33	33	33	33	18	18	32	1	1	1
1	1	1	32	33	33	33	33	33	33	33	33	33	33	33	33	18	18	32	1	1	1
1	1	1	32	33	33	33	33	33	33	33	33	33	33	33	33	18	18	32	1	1	1
1	1	1	32	26	26	26	26	26	26	26	26	26	26	26	26	26	26	32	1	1	1
1	1	1	32	26	26	26	26	26	26	26	26	26	26	26	26	26	26	32	1	1	1
1	1	1	32	26	26	26	26	26	26	26	26	26	26	26	26	26	26	32	1	1	1
1	1	1	32	26	26	26	26	26	26	26	26	26	26	26	26	26	26	32	1	1	1
1	1	1	32	26	26	26	26	26	26	26	26	26	26	26	26	26	26	32	1	1	1
1	1	1	32	26	26	26	26	26	26	26	26	26	26	26	26	26	26	32	1	1	1
1	1	1	32	26	26	26	26	26	26	26	32	32	32	32	32	32	32	32	1	1	1
1	1	1	32	26	26	26	26	26	26	26	32	1	1	1	1	1	1	1	1	1	1
1	1	1	32	26	26	26	26	26	26	26	32	1	1	1	1	1	1	1	1	1	1
1	1	1	32	26	26	26	26	26	26	26	32	1	1	1	1	1	1	1	1	1	1
1	1	1	32	26	26	26	26	26	26	26	32	1	1	1	1	1	1	1	1	1	1
1	1	1	32	26	26	26	26	26	26	26	32	1	1	1	1	1	1	1	1	1	1
1	1	1	32	26	26	26	26	26	26	26	32	1	1	1	1	1	1	1	1	1	1
1	1	1	32	32	32	32	32	32	26	32	32	1	1	1	1	1	1	1	1	1	1
1	1	1	1	1	1	1	1	1	0	1	1	1	1	1	1	1	1	1	1	1	1
1	1	1	1	1	1	1	1	1	1	1	1	1	1	1	1	1	1	1	1	1	1
1	1	1	1	1	1	1	1	1	1	1	1	1	1	1	1	1	1	1	1	1	1
1	1	1	1	1	1	1	1	1	1	1	1	1	1	1	1	1	1	1	1	1	1
402 9 22
403 16 3
403 17 3
680 7 15
681 11 10
101 4 11
101 6 11
101 7 11
101 8 11
101 8 10
101 8 9
101 8 8
56 5 10
713 5 11
16 128 352 
17 160 352
17 192 352
17 224 352
18 256 352
15 256 320
15 256 288
12 256 256
4