35 58
18 14
4
20
0 0
1	1	1	1	1	1	1	1	1	1	1	1	1	1	1	1	1	1	1	1	1	1	1	1	1	1	1	1	1	1	1	1	1	1	1
1	1	1	1	1	1	1	1	1	1	1	1	1	1	1	1	1	1	1	1	1	1	1	1	1	1	1	1	1	1	1	1	1	1	1
1	1	1	1	1	1	1	1	1	1	1	1	1	1	1	1	1	1	1	1	1	1	1	1	1	1	1	1	1	1	1	1	1	1	1
1	1	1	1	1	1	1	1	1	1	1	1	1	1	1	1	1	1	1	1	1	1	34	34	34	34	34	34	34	34	34	34	1	1	1
1	1	1	1	1	1	1	1	1	1	1	1	1	1	1	1	1	1	1	1	1	1	34	35	35	35	35	35	35	35	35	34	1	1	1
1	1	1	1	1	1	1	1	1	1	1	1	1	1	1	1	1	1	1	1	1	1	34	35	35	35	35	35	35	35	35	34	1	1	1
1	1	1	1	1	1	1	1	1	1	1	1	1	1	1	1	1	1	1	1	1	1	35	35	35	35	35	35	35	35	35	34	1	1	1
1	1	1	1	1	1	1	1	1	1	1	1	1	1	1	1	1	1	1	1	1	1	35	25	25	25	25	25	25	25	25	34	1	1	1
1	1	1	1	1	1	1	1	1	1	1	1	1	1	1	1	1	1	1	1	1	1	35	25	25	25	25	25	25	25	25	34	1	1	1
1	1	1	1	1	1	1	1	1	1	1	1	1	1	1	1	1	1	1	1	1	20	25	25	25	25	25	25	25	25	25	34	1	1	1
1	1	1	1	1	1	1	1	1	1	1	1	1	1	1	1	1	1	1	1	20	20	25	25	25	25	25	25	25	25	25	34	1	1	1
1	1	1	1	1	1	1	1	1	1	1	1	1	1	1	1	1	1	1	20	20	1	34	25	25	25	25	25	25	25	25	34	1	1	1
1	1	1	1	1	1	1	1	1	1	1	1	1	1	1	1	1	0	20	20	1	1	34	25	25	25	25	25	25	25	25	34	1	1	1
1	1	1	1	1	1	1	1	1	1	1	1	1	1	1	1	1	0	20	1	1	1	34	25	25	25	25	25	25	25	25	34	1	1	1
1	1	1	1	1	1	1	1	1	1	1	1	1	1	1	1	1	0	1	1	1	1	34	25	25	25	25	25	25	25	25	34	1	1	1
1	1	1	1	1	1	1	1	1	1	1	1	1	1	1	1	1	1	1	1	1	1	34	25	25	25	25	25	25	25	25	34	1	1	1
1	1	1	1	1	1	1	1	1	1	1	1	1	1	1	1	1	1	1	1	1	1	34	25	25	25	25	25	25	25	25	34	1	1	1
1	1	1	1	1	1	1	1	1	1	1	1	1	1	1	1	1	1	1	34	34	34	34	25	25	25	25	25	25	25	25	34	1	1	1
1	1	1	1	1	1	1	1	1	1	1	1	1	1	1	1	1	34	34	34	35	35	35	25	25	25	25	25	25	25	25	34	1	1	1
1	1	1	1	29	29	29	29	34	34	34	34	34	34	34	34	34	34	35	35	35	35	35	25	25	25	25	25	25	25	25	34	1	1	1
1	1	1	1	29	29	29	29	35	35	35	35	35	35	34	35	35	35	35	35	35	35	35	25	25	25	25	25	25	25	25	34	1	1	1
1	1	1	1	29	29	29	29	35	35	35	35	35	35	34	35	35	35	35	35	25	25	25	25	25	25	25	25	25	25	25	34	1	1	1
1	1	1	1	29	29	29	29	35	35	35	35	35	35	34	35	35	35	25	25	25	25	25	25	25	25	25	25	25	25	25	34	1	1	1
1	1	1	1	29	29	29	29	35	35	35	35	35	35	34	25	25	25	25	25	25	25	25	25	25	25	25	25	25	25	25	34	1	1	1
1	1	1	1	29	29	29	29	35	35	35	35	35	35	34	25	25	25	25	25	25	25	25	25	25	25	25	25	25	25	25	34	1	1	1
1	1	1	1	29	29	29	29	29	29	29	29	29	29	34	25	25	25	25	25	25	25	25	25	25	25	25	25	25	25	25	34	1	1	1
1	1	1	1	29	29	29	29	29	29	29	29	29	29	34	25	25	25	25	25	25	25	25	25	25	25	25	25	25	25	25	34	1	1	1
1	1	1	1	29	29	29	29	29	29	29	29	29	29	34	25	25	25	25	25	25	25	25	25	25	25	25	25	25	25	25	34	1	1	1
1	1	1	1	29	29	29	29	29	29	29	29	29	29	34	25	25	25	25	25	25	25	25	25	25	25	25	25	25	25	25	34	1	1	1
1	1	1	1	29	29	29	29	29	29	29	29	29	29	34	25	25	25	25	25	25	25	25	25	25	25	25	25	25	25	25	34	1	1	1
1	1	1	1	29	29	29	29	29	29	29	29	29	29	34	25	25	25	25	25	25	25	25	25	25	25	25	25	25	25	25	34	1	1	1
1	1	1	1	29	29	29	29	29	29	29	29	29	29	34	25	25	25	25	25	25	25	25	25	25	25	25	25	25	25	25	34	1	1	1
1	1	1	1	29	29	29	29	29	29	29	29	29	29	34	25	25	25	25	25	25	25	25	25	25	25	25	25	25	25	25	34	1	1	1
1	1	1	1	29	29	29	29	29	29	29	29	29	29	34	25	25	25	25	25	25	25	25	25	25	25	25	25	25	25	25	34	1	1	1
1	1	1	1	29	29	29	29	29	29	29	29	29	29	34	25	25	25	25	25	25	25	25	25	25	25	25	25	25	25	25	34	1	1	1
1	1	1	1	29	29	29	29	29	29	29	29	29	29	34	25	25	25	25	25	25	25	25	25	25	25	25	25	25	25	25	34	1	1	1
1	1	1	1	29	29	29	29	29	29	29	29	29	29	34	25	25	25	25	25	25	25	25	25	25	25	25	25	25	25	25	34	1	1	1
1	1	1	1	29	29	29	29	29	29	29	29	29	29	34	25	25	25	25	25	25	25	25	25	25	25	25	25	25	25	25	34	1	1	1
1	1	1	1	29	29	29	29	29	29	29	29	29	29	34	25	25	25	25	25	25	25	25	25	25	25	25	25	25	25	25	34	1	1	1
1	1	1	1	29	29	29	29	29	29	29	29	29	29	34	25	25	25	25	25	25	25	25	25	25	25	25	25	25	25	25	34	1	1	1
1	1	1	1	29	29	29	29	29	29	29	29	29	29	34	25	25	25	25	25	25	25	25	25	25	25	25	25	25	25	25	34	1	1	1
1	1	1	1	29	29	29	29	29	29	29	29	29	29	34	25	25	25	34	34	34	34	34	25	25	25	25	25	25	25	25	34	1	1	1
1	1	1	1	29	29	29	29	29	29	29	29	29	29	34	25	25	34	34	34	1	1	34	25	25	25	25	25	25	25	25	34	1	1	1
1	1	1	1	29	29	29	29	34	34	34	34	34	34	34	34	34	34	1	1	1	1	34	25	25	25	25	25	25	25	25	34	1	1	1
1	1	1	1	1	1	1	1	1	1	1	1	1	1	1	1	1	1	1	1	1	1	34	25	25	25	25	25	25	25	25	34	1	1	1
1	1	1	1	1	1	1	1	1	1	1	1	1	1	1	1	1	1	1	1	1	1	34	25	25	25	25	25	25	25	25	34	1	1	1
1	1	1	1	1	1	1	1	1	1	1	1	1	1	1	1	1	1	1	1	1	1	34	25	25	25	25	25	25	25	25	34	1	1	1
1	1	1	1	1	1	1	1	1	1	1	1	1	1	1	1	1	1	1	1	1	1	34	25	25	25	25	25	25	25	25	34	1	1	1
1	1	1	1	1	1	1	1	1	1	1	1	1	1	1	1	1	1	1	1	1	1	34	25	25	25	25	25	25	25	25	34	1	1	1
1	1	1	1	1	1	1	1	1	1	1	1	1	1	1	1	1	1	1	1	1	1	34	25	25	25	25	25	25	25	25	34	1	1	1
1	1	1	1	1	1	1	1	1	1	1	1	1	1	1	1	1	1	1	1	1	1	34	25	25	25	25	25	25	25	25	34	1	1	1
1	1	1	1	1	1	1	1	1	1	1	1	1	1	1	1	1	1	1	1	1	1	34	25	25	25	25	25	25	25	25	34	1	1	1
1	1	1	1	1	1	1	1	1	1	1	1	1	1	1	1	1	1	1	1	1	1	34	25	25	25	25	25	25	25	25	34	1	1	1
1	1	1	1	1	1	1	1	1	1	1	1	1	1	1	1	1	1	1	1	1	1	34	34	34	34	25	34	34	34	34	34	1	1	1
1	1	1	1	1	1	1	1	1	1	1	1	1	1	1	1	1	1	1	1	1	1	1	1	1	1	0	1	1	1	1	1	1	1	1
1	1	1	1	1	1	1	1	1	1	1	1	1	1	1	1	1	1	1	1	1	1	1	1	1	1	1	1	1	1	1	1	1	1	1
1	1	1	1	1	1	1	1	1	1	1	1	1	1	1	1	1	1	1	1	1	1	1	1	1	1	1	1	1	1	1	1	1	1	1
1	1	1	1	1	1	1	1	1	1	1	1	1	1	1	1	1	1	1	1	1	1	1	1	1	1	1	1	1	1	1	1	1	1	1
396 17 12
396 17 13
396 17 14
397 26 54
32 576 352
32 608 320
32 640 288
32 672 256
33 576 384
33 608 352
33 640 320
33 672 288
33 576 416
33 608 384
33 640 352
33 672 320
34 576 448
34 608 416
34 640 384
34 672 352
35 576 480
35 608 448
35 640 416
35 672 384
4