28 39
16 34
8
0
0 0
1	1	1	1	1	1	1	1	1	1	1	1	1	1	1	1	1	1	1	1	1	1	1	1	1	1	1	1
1	1	1	1	1	1	1	1	1	1	1	1	1	1	1	1	1	1	1	1	1	1	1	1	1	1	1	1
1	1	1	1	1	1	1	1	1	1	1	1	1	1	1	1	1	1	1	1	1	1	1	1	1	1	1	1
1	1	1	32	32	32	32	32	32	32	32	32	0	0	0	32	32	32	32	32	32	32	32	32	32	1	1	1
1	1	1	32	33	33	33	33	33	33	33	33	18	18	18	33	33	33	33	33	33	33	33	33	32	1	1	1
1	1	1	32	33	33	33	33	33	33	33	33	18	18	18	33	33	33	33	33	33	33	33	33	32	1	1	1
1	1	1	32	33	33	33	33	33	33	33	33	18	18	18	33	33	33	33	33	33	33	33	33	32	1	1	1
1	1	1	32	26	26	26	26	26	26	26	26	26	26	26	26	26	26	26	26	26	26	26	26	32	1	1	1
1	1	1	32	26	26	26	26	26	26	26	26	26	26	26	26	26	26	26	26	26	26	26	26	32	1	1	1
1	1	1	32	26	26	26	26	26	26	26	26	26	26	26	26	26	26	26	26	26	26	26	26	32	1	1	1
1	1	1	32	26	26	26	26	26	26	26	26	26	26	26	26	26	26	26	26	26	26	26	26	32	1	1	1
1	1	1	32	26	26	26	26	26	26	26	26	26	26	26	26	26	26	26	26	26	26	26	26	32	1	1	1
1	1	1	32	26	26	26	26	26	26	26	26	26	26	26	26	26	26	26	26	26	26	26	26	32	1	1	1
1	1	1	32	26	26	26	26	26	26	26	26	26	26	26	26	26	26	26	26	26	26	26	26	32	1	1	1
1	1	1	32	26	26	26	26	26	26	26	26	26	26	26	26	26	26	26	26	26	26	26	26	32	1	1	1
1	1	1	32	26	26	26	26	26	26	26	26	26	26	26	26	26	26	26	26	26	26	26	26	32	1	1	1
1	1	1	32	26	26	26	26	26	26	26	26	26	26	26	26	26	26	26	26	26	26	26	26	32	1	1	1
1	1	1	32	26	26	26	26	26	26	26	26	26	26	26	26	26	26	26	26	26	26	26	26	32	1	1	1
1	1	1	32	26	26	26	26	26	26	26	26	26	26	26	26	26	26	26	26	26	26	26	26	32	1	1	1
1	1	1	32	26	26	26	26	26	26	26	26	26	32	32	32	32	32	32	32	32	32	32	32	32	1	1	1
1	1	1	32	26	26	26	26	26	26	26	26	26	32	1	1	1	1	1	1	1	1	1	1	1	1	1	1
1	1	1	32	26	26	26	26	26	26	26	26	26	32	1	1	1	1	1	1	1	1	1	1	1	1	1	1	
1	1	1	32	26	26	26	26	26	26	26	26	26	32	32	32	32	32	32	1	1	1	1	1	1	1	1	1
1	1	1	32	26	26	26	26	26	26	26	26	26	33	33	33	33	33	32	1	1	1	1	1	1	1	1	1	
1	1	1	32	26	26	26	26	26	26	26	26	26	33	33	33	33	33	32	1	1	1	1	1	1	1	1	1	
1	1	1	32	26	26	26	26	26	26	26	26	26	33	33	33	33	33	32	1	1	1	1	1	1	1	1	1	
1	1	1	32	26	26	26	26	26	26	26	26	26	26	26	26	26	26	32	1	1	1	1	1	1	1	1	1
1	1	1	32	26	26	26	26	26	26	26	26	26	26	26	26	26	26	32	1	1	1	1	1	1	1	1	1
1	1	1	32	26	26	26	26	26	26	26	26	26	26	26	26	26	26	32	1	1	1	1	1	1	1	1	1
1	1	1	32	26	26	26	26	26	26	26	26	26	26	26	26	26	26	32	1	1	1	1	1	1	1	1	1
1	1	1	32	26	26	26	26	26	26	26	26	26	26	26	26	26	26	32	1	1	1	1	1	1	1	1	1
1	1	1	32	26	26	26	26	26	26	26	26	26	26	26	26	26	26	32	1	1	1	1	1	1	1	1	1
1	1	1	32	32	32	32	32	32	32	32	32	32	32	32	32	19	19	32	1	1	1	1	1	1	1	1	1
1	1	1	1	1	1	1	1	1	1	1	1	1	1	1	1	19	19	1	1	1	1	1	1	1	1	1	1
1	1	1	1	1	1	1	1	1	1	1	1	1	1	1	1	19	19	1	1	1	1	1	1	1	1	1	1
1	1	1	1	1	1	1	1	1	1	1	1	1	1	1	1	0	0	1	1	1	1	1	1	1	1	1	1
1	1	1	1	1	1	1	1	1	1	1	1	1	1	1	1	1	1	1	1	1	1	1	1	1	1	1	1
1	1	1	1	1	1	1	1	1	1	1	1	1	1	1	1	1	1	1	1	1	1	1	1	1	1	1	1
1	1	1	1	1	1	1	1	1	1	1	1	1	1	1	1	1	1	1	1	1	1	1	1	1	1	1	1
400 12 3
400 13 3
400 14 3
401 16 35
401 17 35
677 6 11
678 20 17
679 14 27
3