32 36
25 26
8
0
0 0
1	1	1	1	1	1	1	1	1	1	1	1	1	1	1	1	1	1	1	1	1	1	1	1	1	1	1	1	1	1	1	1	
1	1	1	1	1	1	1	1	1	1	1	1	1	1	1	1	1	1	1	1	1	1	1	1	1	1	1	1	1	1	1	1
1	1	1	1	1	1	1	1	1	1	1	1	1	1	1	1	1	1	1	1	1	1	1	1	1	1	1	1	1	1	1	1
1	1	1	1	1	1	1	1	1	1	1	1	1	1	1	1	30	30	30	30	30	30	30	1	1	1	1	1	1	1	1	1
1	1	1	1	1	1	1	1	1	1	1	1	1	1	1	1	30	31	31	31	31	31	30	1	1	1	1	1	1	1	1	1
1	1	1	1	1	1	1	1	1	1	1	1	1	1	1	1	30	31	31	31	31	31	30	1	1	1	1	1	1	1	1	1
1	1	1	1	1	1	1	1	1	1	1	1	1	1	1	1	30	31	31	31	31	31	30	1	1	1	1	1	1	1	1	1
1	1	1	1	1	1	1	1	1	1	1	1	1	1	1	1	30	25	25	25	25	25	30	1	1	1	1	1	1	1	1	1
1	1	1	1	1	1	1	1	1	1	1	1	1	1	1	1	30	25	25	25	25	25	30	1	1	1	1	1	1	1	1	1
1	1	1	1	1	1	1	1	1	1	1	1	1	1	1	1	30	25	25	25	25	25	30	1	1	1	1	1	1	1	1	1
1	1	1	1	1	1	1	1	1	1	1	1	1	1	1	1	30	25	25	25	25	25	30	1	1	1	1	1	1	1	1	1
1	1	1	1	1	1	1	1	1	1	1	1	1	1	1	1	30	25	25	25	25	25	30	1	1	1	0	0	1	1	1	1
1	1	1	1	1	1	1	1	1	1	30	30	30	30	30	30	30	30	30	25	30	30	30	30	30	30	19	19	30	1	1	1
1	1	1	1	1	1	1	1	1	1	30	31	31	31	31	31	31	31	31	25	31	31	31	31	31	31	19	19	30	1	1	1
1	1	1	1	1	1	1	1	1	1	30	31	31	31	31	31	31	31	31	25	31	31	31	31	31	31	19	19	30	1	1	1
1	1	1	1	1	1	1	1	1	1	30	31	31	31	31	31	31	31	31	25	31	31	31	31	31	31	19	19	30	1	1	1
1	1	1	1	1	1	1	1	1	1	30	25	25	25	25	25	25	25	25	25	25	25	25	25	25	25	25	25	30	1	1	1
1	1	1	1	30	30	30	30	30	30	30	25	25	25	25	25	25	25	25	25	25	25	25	25	25	25	25	25	30	1	1	1
1	1	1	1	30	31	31	31	31	31	30	25	25	25	25	25	25	25	25	25	25	25	25	25	25	25	25	25	30	1	1	1
1	1	1	1	30	31	31	31	31	31	31	25	25	25	25	25	25	25	25	25	25	25	25	25	25	25	25	25	30	1	1	1
1	1	1	1	30	31	31	31	31	31	31	25	25	25	25	25	25	25	25	25	25	25	25	25	25	25	25	25	30	1	1	1
1	1	1	1	30	25	25	25	25	25	31	25	25	25	25	25	30	30	30	30	30	30	30	25	25	25	25	25	30	1	1	1
1	1	1	1	30	25	25	25	25	25	25	25	25	25	25	25	30	1	1	1	1	1	30	25	25	25	25	25	30	1	1	1
1	1	1	1	30	25	25	25	25	25	25	25	25	25	25	25	30	1	1	1	1	1	30	25	25	25	25	25	30	1	1	1
1	1	1	1	30	25	25	25	25	25	25	25	25	25	25	25	30	1	1	1	1	1	30	25	25	25	25	25	30	1	1	1
1	1	1	1	30	25	25	25	25	25	25	25	25	25	25	25	30	1	1	1	1	1	30	25	25	25	25	25	30	1	1	1
1	1	1	1	30	25	25	25	25	25	25	25	25	25	30	30	30	1	1	1	1	1	30	30	30	25	30	30	30	1	1	1
1	1	1	1	30	25	25	25	25	25	25	25	25	25	30	1	1	1	1	1	1	1	1	1	1	0	1	1	1	1	1	1
1	1	1	1	30	25	25	25	25	25	25	25	25	25	30	1	1	1	1	1	1	1	1	1	1	1	1	1	1	1	1	1
1	1	1	1	30	25	25	25	25	25	25	25	25	25	30	1	1	1	1	1	1	1	1	1	1	1	1	1	1	1	1	1
1	1	1	1	30	25	25	25	25	25	25	25	25	25	30	1	1	1	1	1	1	1	1	1	1	1	1	1	1	1	1	1
1	1	1	1	30	25	25	25	25	25	25	25	25	25	30	1	1	1	1	1	1	1	1	1	1	1	1	1	1	1	1	1
1	1	1	1	30	30	30	30	30	30	30	30	30	30	30	1	1	1	1	1	1	1	1	1	1	1	1	1	1	1	1	1
1	1	1	1	1	1	1	1	1	1	1	1	1	1	1	1	1	1	1	1	1	1	1	1	1	1	1	1	1	1	1	1
1	1	1	1	1	1	1	1	1	1	1	1	1	1	1	1	1	1	1	1	1	1	1	1	1	1	1	1	1	1	1	1
1	1	1	1	1	1	1	1	1	1	1	1	1	1	1	1	1	1	1	1	1	1	1	1	1	1	1	1	1	1	1	1
371 25 27
372 26 11
372 27 11
373 19 6
374 7 20
640 27 20
641 5 22
642 13 19
3