28 45
21 31
5
0
0 0
1	1	1	1	1	1	1	1	1	1	1	1	1	1	1	1	1	1	1	1	1	1	1	1	1	1	1	1
1	1	1	1	1	1	1	1	1	1	1	1	1	1	1	1	1	1	1	1	1	1	1	1	1	1	1	1
1	1	1	1	1	1	1	1	1	1	1	1	1	1	1	1	1	1	1	1	1	1	1	1	1	1	1	1
1	1	1	1	1	1	32	32	32	32	32	32	32	32	1	1	1	1	1	1	1	1	1	1	1	1	1	1
1	1	1	1	1	1	32	33	33	33	33	33	33	32	1	1	1	1	1	1	1	1	1	1	1	1	1	1
1	1	1	1	1	1	32	33	33	33	33	33	33	32	1	1	1	1	1	1	1	1	1	1	1	1	1	1
1	1	1	1	1	1	32	33	33	33	33	33	33	32	32	32	32	32	32	32	32	32	32	32	1	1	1	1
1	1	1	1	1	1	32	26	26	26	26	26	26	33	33	33	33	33	33	33	33	33	33	32	1	1	1	1
1	1	1	1	1	1	32	26	26	26	26	26	26	33	33	33	33	33	33	33	33	33	33	32	1	1	1	1
1	1	1	1	1	1	32	26	26	26	26	26	26	33	33	33	33	33	33	33	33	33	33	32	1	1	1	1
1	1	1	1	1	1	32	26	26	26	26	26	26	26	26	26	26	26	26	26	26	26	26	32	1	1	1	1
1	1	1	1	1	1	32	26	26	26	26	26	26	26	26	26	26	26	26	26	26	26	26	32	1	1	1	1
1	1	1	1	1	1	32	26	26	26	26	26	26	26	26	26	26	26	26	26	26	26	26	32	1	1	1	1
1	1	1	1	1	1	32	26	26	26	26	26	26	26	26	26	26	26	26	26	26	26	26	32	1	1	1	1
1	1	1	1	1	1	32	26	26	26	26	26	26	26	26	26	26	26	26	26	26	26	26	32	1	1	1	1
1	1	1	1	1	1	32	26	26	26	26	26	26	26	26	26	26	26	26	26	26	26	26	32	1	1	1	1
1	1	1	1	1	1	32	32	32	32	32	32	32	32	32	32	26	26	26	26	26	26	26	32	1	1	1	1
1	1	1	1	1	1	32	33	33	33	33	33	33	33	33	33	26	26	26	26	26	26	26	32	1	1	1	1
1	1	1	1	1	1	32	33	33	33	33	33	33	33	33	33	26	26	26	26	26	26	26	32	1	1	1	1
1	1	1	1	1	1	32	33	33	33	33	33	33	33	33	33	26	26	26	26	26	26	26	32	1	1	1	1
1	1	1	1	1	1	32	26	26	26	26	26	26	26	26	26	26	26	26	26	26	26	26	32	1	1	1	1
1	1	1	1	1	1	32	26	26	26	26	26	26	26	26	26	26	26	26	26	26	26	26	32	1	1	1	1
1	1	1	1	1	1	32	26	26	26	26	26	26	26	26	26	26	26	26	26	26	26	26	32	1	1	1	1
1	1	1	1	1	1	32	26	26	26	26	26	26	26	26	26	26	26	26	26	26	26	26	32	1	1	1	1
1	1	1	1	1	1	32	26	26	26	26	26	26	26	26	26	26	26	26	26	26	26	26	32	1	1	1	1
1	1	1	1	1	1	32	26	26	26	26	26	26	26	26	26	26	26	26	26	26	26	26	32	1	1	1	1
1	1	1	1	1	1	32	26	26	26	26	26	26	26	26	26	26	26	26	26	26	26	26	32	1	1	1	1
1	1	1	32	32	32	32	32	32	32	32	32	26	26	26	26	26	32	32	32	26	26	26	32	1	1	1	1
1	1	1	32	33	33	33	33	33	33	33	33	26	26	26	26	26	33	33	32	26	26	26	32	1	1	1	1
1	1	1	32	33	33	33	33	33	33	33	33	26	26	26	26	26	33	33	32	26	26	26	32	1	1	1	1
1	1	1	32	33	33	33	33	33	33	33	33	26	26	26	26	26	33	33	32	26	26	26	32	1	1	1	1
1	1	1	32	26	26	26	26	26	26	26	26	26	26	26	26	26	26	26	32	32	26	32	32	1	1	1	1
1	1	1	32	26	26	26	26	26	26	26	26	26	26	26	26	26	26	26	32	1	0	1	1	1	1	1	1
1	1	1	32	26	26	26	26	26	26	26	26	26	26	26	26	26	26	26	32	1	1	1	1	1	1	1	1
1	1	1	32	26	26	26	26	26	26	26	26	26	26	26	26	26	26	26	32	1	1	1	1	1	1	1	1
1	1	1	32	26	26	26	26	26	26	26	26	26	26	26	26	26	26	26	32	1	1	1	1	1	1	1	1
1	1	1	32	26	26	26	26	26	26	26	26	26	26	26	26	26	26	32	32	1	1	1	1	1	1	1	1
1	1	1	32	26	26	26	26	26	26	26	26	26	26	26	26	26	26	32	1	1	1	1	1	1	1	1	1
1	1	1	32	26	26	26	26	26	26	26	26	26	26	26	26	26	26	32	1	1	1	1	1	1	1	1	1
1	1	1	32	26	26	26	26	26	26	26	26	26	26	26	26	26	26	32	1	1	1	1	1	1	1	1	1
1	1	1	32	26	26	26	26	26	26	26	26	26	26	26	26	26	26	32	1	1	1	1	1	1	1	1	1
1	1	1	32	32	32	32	32	32	32	32	32	32	32	32	32	32	32	32	1	1	1	1	1	1	1	1	1
1	1	1	1	1	1	1	1	1	1	1	1	1	1	1	1	1	1	1	1	1	1	1	1	1	1	1	1
1	1	1	1	1	1	1	1	1	1	1	1	1	1	1	1	1	1	1	1	1	1	1	1	1	1	1	1
1	1	1	1	1	1	1	1	1	1	1	1	1	1	1	1	1	1	1	1	1	1	1	1	1	1	1	1
375 21 32
376 17 9
643 12 14
644 9 34
645 10 24
3