27 37
4 30
12
14
0 0
1	1	1	1	1	1	1	1	1	1	1	1	1	1	1	1	1	1	1	1	1	1	1	1	1	1	1
1	1	1	1	1	1	1	1	1	1	1	1	1	1	1	1	1	1	1	1	1	1	1	1	1	1	1
1	1	1	1	1	1	1	1	1	1	1	1	1	1	1	1	1	1	1	1	1	1	1	1	1	1	1
1	1	1	1	34	34	34	34	34	34	34	34	34	34	34	34	34	34	34	34	34	34	34	1	1	1	1
1	1	1	1	34	35	35	35	35	35	35	35	35	35	35	35	35	35	35	35	35	35	35	0	1	1	1
1	1	1	1	34	35	35	35	35	35	35	35	35	35	35	35	35	35	35	35	35	35	20	0	1	1	1
1	1	1	1	34	35	35	35	35	35	35	35	35	35	35	35	35	35	35	35	35	20	20	0	1	1	1
1	1	1	1	34	41	41	41	41	41	41	41	41	41	41	41	41	41	41	41	20	20	1	1	1	1	1
1	1	1	1	34	41	41	41	41	41	41	41	41	41	41	41	41	41	41	41	20	1	1	1	1	1	1
1	1	1	1	34	41	41	41	41	41	41	41	41	41	41	41	41	41	41	41	34	1	1	1	1	1	1
1	1	1	1	34	41	41	41	41	41	41	41	41	41	41	41	41	41	41	41	34	1	1	1	1	1	1
1	1	1	1	34	41	41	41	41	41	41	41	41	41	41	41	41	41	41	41	34	1	1	1	1	1	1
1	1	1	1	34	41	41	41	41	41	41	41	41	41	41	41	41	41	41	41	35	1	1	1	1	1	1
1	1	1	1	34	41	41	41	41	41	41	41	41	41	41	41	41	41	41	41	35	1	1	1	1	1	1
1	1	1	1	34	41	41	41	41	41	41	41	41	41	41	41	41	41	41	41	35	1	1	1	1	1	1
1	1	1	1	34	41	41	41	41	41	41	41	41	41	41	41	41	41	41	41	41	0	1	1	1	1	1
1	1	1	1	34	41	41	41	41	41	41	41	41	41	41	41	41	41	41	41	34	1	1	1	1	1	1
1	1	1	1	34	41	41	41	41	41	41	41	41	41	41	41	41	41	41	41	34	1	1	1	1	1	1
1	1	1	1	34	41	41	41	41	41	41	41	41	41	41	41	41	41	41	41	34	1	1	1	1	1	1
1	1	1	1	34	19	19	19	34	34	34	34	34	34	34	34	34	34	34	34	34	1	1	1	1	1	1
1	1	1	1	34	19	19	19	34	1	1	1	1	1	1	1	1	1	1	1	1	1	1	1	1	1	1
1	1	1	1	34	19	19	19	34	1	1	1	1	1	1	1	1	1	1	1	1	1	1	1	1	1	1
1	1	1	1	34	19	19	19	34	34	34	34	1	1	1	1	1	1	1	1	1	1	1	1	1	1	1
1	1	1	1	34	19	19	19	35	35	35	34	1	1	1	1	1	1	1	1	1	1	1	1	1	1	1
1	1	1	1	34	19	19	19	35	35	35	34	1	1	1	1	1	1	1	1	1	1	1	1	1	1	1
1	1	1	1	34	19	19	19	35	35	35	34	1	1	1	1	1	1	1	1	1	1	1	1	1	1	1
1	1	1	1	34	26	26	26	26	26	26	34	1	1	1	1	1	1	1	1	1	1	1	1	1	1	1
1	1	1	1	35	26	26	26	26	26	26	34	1	1	1	1	1	1	1	1	1	1	1	1	1	1	1
1	1	1	1	35	26	26	26	26	26	26	34	1	1	1	1	1	1	1	1	1	1	1	1	1	1	1
1	1	1	1	35	26	26	26	26	26	26	34	1	1	1	1	1	1	1	1	1	1	1	1	1	1	1
1	1	1	0	26	26	26	26	26	26	26	34	1	1	1	1	1	1	1	1	1	1	1	1	1	1	1
1	1	1	1	34	26	26	26	26	26	26	34	1	1	1	1	1	1	1	1	1	1	1	1	1	1	1
1	1	1	1	34	26	26	26	26	26	26	34	1	1	1	1	1	1	1	1	1	1	1	1	1	1	1
1	1	1	1	34	34	34	34	34	34	34	34	1	1	1	1	1	1	1	1	1	1	1	1	1	1	1
1	1	1	1	1	1	1	1	1	1	1	1	1	1	1	1	1	1	1	1	1	1	1	1	1	1	1
1	1	1	1	1	1	1	1	1	1	1	1	1	1	1	1	1	1	1	1	1	1	1	1	1	1	1
1	1	1	1	1	1	1	1	1	1	1	1	1	1	1	1	1	1	1	1	1	1	1	1	1	1	1
379 3 30
380 6 6
381 12 6
382 18 6
383 21 15
384 23 4
384 23 5
384 23 6
650 9 26
651 13 7
652 19 12
653 15 18
32 640 192
32 672 160
32 704 128
33 640 224
33 672 192
33 704 160
33 640 256
33 672 224
33 704 192
34 640 288
34 672 256
34 704 224
35 672 288
35 704 256
4
