13 12
6 7
0
0
0 0
1	1	1	1	1	1	1	1	1	1	1	1	1
1	1	1	1	1	1	1	1	1	1	1	1	1
1	1	1	1	1	1	1	1	1	1	1	1	1
1	1	1	42	42	42	42	42	42	42	1	1	1
1	1	1	42	42	42	42	42	42	42	1	1	1
1	1	1	42	42	42	42	42	42	42	1	1	1
1	1	1	42	42	42	42	42	42	42	1	1	1
1	1	1	42	42	42	42	42	42	42	1	1	1
1	1	1	1	1	1	42	1	1	1	1	1	1
1	1	1	1	1	1	1	1	1	1	1	1	1
1	1	1	1	1	1	1	1	1	1	1	1	1
1	1	1	1	1	1	1	1	1	1	1	1	1
1