12 12
3 8
10
0 8
2   2   126 133 128 2   2   2   2   2   2   2
126 133 134 115 132 133 131 2   2   2   2   2
131 115 115 1   115 115 132 133 133 133 133 128
131 121 121 36  121 121 115 115 115 115 115 131
131 36  36  36  36  36  121 121 121 121 121 131
131 36  36  36  36  36  36  36  36  36  36  131
131 36  36  36  36  36  36  36  36  36  36  131
131 36  36  36  36  36  36  36  36  36  36  131
131 36  36  36  36  36  36  36  36  36  36  131
131 36  36  36  36  36  36  36  36  36  36  131
131 36  36  36  36  36  36  36  36  36  36  131
132 133 133 133 133 133 133 133 133 133 133 134
1 3 2
100 1 4
79 9 8
80 9 9
81 2 10
82 3 10
83 9 4
84 2 2
85 2 3
96 9 5
1 10
2 10
3 10
4 10
5 10
6 10
7 10
9 10

