12 12
3 8
3
5 3
2   2   126 133 128 2   2   2   2   2   2   2
126 133 134 115 132 133 131 2   2   2   2   2
131 115 115 1   115 115 132 133 133 133 133 128
131 121 121 36  121 121 115 115 115 115 115 131
131 36  36  36  36  36  121 121 121 121 121 131
131 36  36  36  36  36  36  36  36  36  36  131
131 36  36  36  36  36  36  36  36  36  36  131
131 36  36  36  36  36  36  36  36  36  36  131
131 36  36  36  36  36  36  36  36  36  36  131
131 36  36  36  36  36  36  36  36  36  36  131
131 36  36  36  36  36  36  36  36  36  36  131
132 133 133 133 133 133 133 133 133 133 133 134
1 3 2
100 1 4
101 3 7
0 1
1 1
2 1
