12 10
2 7
1
181 188 188 188 188 188 188 188 188 188 188 183
186 170 170 170 170 170 170 170 170 170 170 184
186 176 176 176 176 176 176 176 176 176 176 184
186 58  58  58  58  58  58  58  58  58  58  184
186 58  58  58  58  58  58  58  58  58  58  184
186 58  58  58  58  58  58  58  58  58  58  184
186 58  58  58  58  58  58  58  58  58  58  184
186 58  58  58  58  58  58  58  58  58  58  184
187 188 58  188 188 188 188 188 188 188 188 189
2   2   1   2   2   2   2   2   2   2   2   2  
13 2 9