12 12
2 7
26
5 3
181 188 188 188 188 188 188 188 188 188 188 183
186 170 170 170 170 170 170 170 170 170 170 184
186 176 176 176 176 176 176 176 176 176 176 184
186 58  58  58  58  58  58  58  58  58  58  184
186 58  58  58  58  58  58  58  58  58  58  184
186 58  58  58  58  58  58  58  58  58  58  184
186 58  58  58  58  58  58  58  58  58  58  184
186 58  58  58  58  58  58  58  58  58  58  184
186 58  58  58  58  58  58  58  58  58  58  184
186 58  58  58  58  58  58  58  58  58  58  184
187 188 58  188 188 188 188 188 188 188 188 189
2   2   1   2   2   2   2   2   2   2   2   2  
13 2 11
68 3 8
69 5 8
70 2 6
71 3 4
72 8 3
73 10 6
108 3 5
109 4 5
109 5 5
109 6 5
109 7 5
110 8 5
111 3 6
112 4 6
112 5 6
112 6 6
112 7 6
113 8 6
114 3 7
115 4 7
115 5 7
115 6 7
115 7 7
116 8 7
90 7 1
7 20
3 10
4 2
