12 10
2 7
7
20 2
181 188 188 188 188 188 188 188 188 188 188 183
186 170 170 170 170 170 170 170 170 170 170 184
186 176 176 176 176 176 176 176 176 176 176 184
186 58  58  58  58  58  58  58  58  58  58  184
186 58  58  58  58  58  58  58  58  58  58  184
186 58  58  58  58  58  58  58  58  58  58  184
186 58  58  58  58  58  58  58  58  58  58  184
186 58  58  58  58  58  58  58  58  58  58  184
187 188 58  188 188 188 188 188 188 188 188 189
2   2   1   2   2   2   2   2   2   2   2   2  
13 2 9
68 3 7
69 6 7
70 1 6
71 1 3
72 7 3
73 10 5
7 20
3 10
4 2
