12 13
10 6
1
0 0
2   188 188 188 188 188 188 188 188 188 188 2
2   186 170 170 170 170 170 170 170 170 186 2
2   186 176 176 176 176 176 176 176 176 186 2
2   186 91  91  91  91  91  91  91  91  186 2
2   186 91  91  91  91  91  91  91  91  186 2
2   186 91  91  91  91  91  91  91  91  170 2
2   186 91  91  91  91  91  91  91  91  176 2
2   186 91  91  91  91  91  91  91  91  91  1
2   186 91  91  91  91  91  91  91  91  186 2
2   186 91  91  91  91  91  91  91  91  186 2
2   186 91  91  91  91  91  91  91  91  186 2
2   186 91  91  91  91  91  91  91  91  186 2
2   187 188 188 188 188 188 188 188 188 189 2
34 11 7
