21 24
10 15
43
20 5
2   2   181 188 188 188 188 188 188 188 188 188 188 188 188 188 188 188 183 2   2
2   2   186 170 170 170 170 170 170 170 170 170 170 170 170 170 170 170 186 2   2
2   2   186 176 176 176 176 176 176 176 186 176 176 176 176 176 176 176 186 2   2
2   2   186 91  91  91  91  91  91  91  186 91  91  91  91  91  91  91  186 2   2
2   2   186 91  91  91  91  91  91  91  186 91  91  91  91  91  91  91  186 2   2
2   2   184 91  91  91  91  91  91  91  186 91  91  91  91  91  91  91  186 2   2
2   2   186 91  91  91  91  91  91  91  186 91  91  91  91  91  91  91  186 2   2
2   2   186 91  91  91  91  91  91  91  186 91  91  91  91  91  91  91  186 2   2
2   2   186 91  91  91  91  91  91  91  186 91  91  91  91  91  91  91  186 2   2
2   2   184 91  91  91  91  91  91  91  186 91  91  91  91  91  91  91  186 2   2
2   2   186 91  91  91  91  91  91  91  186 91  91  91  91  91  91  91  186 2   2
2   2   184 188 188 91  91  91  91  91  186 91  91  91  91  91  188 188 186 2   2
2   188 188 176 176 91  91  91  91  91  186 91  91  91  91  91  176 176 188 188 2
2   170 170 91  91  91  91  91  91  91  186 91  91  91  91  91  91  91  170 170 2
2   176 176 91  91  91  91  91  188 188 188 188 188 91  91  91  91  91  176 176 2
1   91  91  91  91  91  91  91  176 176 176 176 176 91  91  91  91  91  91  91  1
2   188 186 91  91  91  91  91  91  91  91  91  91  91  91  91  91  91  186 188 2
2   2   186 91  91  91  91  91  91  91  91  91  91  91  91  91  91  91  186 2   2
2   2   186 91  91  91  91  91  91  91  91  91  91  91  91  91  91  91  186 2   2
2   2   184 188 188 91  91  91  91  91  185 91  91  91  91  91  188 188 186 2   2
2   2   186 176 176 91  91  91  95  97  186 91  91  91  91  91  176 176 186 2   2
2   2   186 91  91  91  91  91  98  100 186 91  91  91  91  91  91  91  186 2   2
2   2   186 91  91  91  91  91  101 103 186 91  91  91  91  91  91  91  186 2   2
2   2   182 182 182 182 182 182 182 182 182 182 182 182 182 182 182 182 182 2   2
11 0 15
12 20 15 
53 11 12
54 11 8
55 11 4
56 16 4
57 16 8
58 8 12
59 8 8
60 3 4
61 3 8
62 8 4
63 8 21
64 11 21
77 4 13
95 3 3
101 4 3
95 8 3
101 9 3
95 11 3
101 12 3
95 16 3
101 17 3
95 3 7
101 4 7
95 8 7
101 9 7
95 11 7
101 12 7
95 16 7
101 17 7
95 8 11
101 9 11
95 11 11
101 12 11
95 8 20
101 9 20
95 11 20
101 12 20
97 3 12
98 3 13
118 16 13
119 6 3
1 10
2 10
6 10
4 2
9 4