21 24
10 15
14
2   2   181 188 188 188 188 188 188 188 188 188 188 188 188 188 188 188 183 2   2
2   2   186 170 170 170 170 170 170 170 170 170 170 170 170 170 170 170 186 2   2
2   2   186 176 176 176 176 176 176 176 186 176 176 176 176 176 176 176 186 2   2
2   2   186 91  91  91  91  91  91  91  186 91  91  91  91  91  91  91  186 2   2
2   2   186 91  91  91  91  91  91  91  186 91  91  91  91  91  91  91  186 2   2
2   2   184 188 188 91  91  91  188 188 186 188 188 91  91  91  188 188 186 2   2
2   2   186 176 176 91  91  91  176 176 186 176 176 91  91  91  176 176 186 2   2
2   2   186 91  91  91  91  91  91  91  186 91  91  91  91  91  91  91  186 2   2
2   2   186 91  91  91  91  91  91  91  186 91  91  91  91  91  91  91  186 2   2
2   2   184 91  91  91  91  91  188 188 186 188 188 91  91  91  188 188 186 2   2
2   2   186 91  91  91  91  91  176 176 186 176 176 91  91  91  176 176 186 2   2
2   2   184 188 188 91  91  91  91  91  186 91  91  91  91  91  91  91  186 2   2
2   188 188 176 176 91  91  91  91  91  186 91  91  91  91  91  91  91  188 188 2
2   170 170 91  91  91  91  91  188 188 188 188 188 91  91  91  91  91  170 170 2
2   176 176 91  91  91  91  91  176 176 176 176 176 91  91  91  91  91  176 176 2
1   91  91  91  91  91  91  91  91  91  91  91  91  91  91  91  91  91  91  91  1
2   188 186 91  91  91  91  91  91  91  91  91  91  91  91  91  91  91  186 188 2
2   2   186 91  91  91  91  91  91  91  91  91  91  91  91  91  91  91  186 2   2
2   2   186 91  91  91  91  91  91  91  91  91  91  91  91  91  91  91  186 2   2
2   2   184 188 188 91  91  91  188 188 185 188 188 91  91  91  188 188 186 2   2
2   2   186 176 176 91  91  91  176 176 186 176 176 91  91  91  176 176 186 2   2
2   2   186 91  91  91  91  91  95  97  186 91  91  91  91  91  91  91  186 2   2
2   2   186 91  91  91  91  91  101 103 186 91  91  91  91  91  91  91  186 2   2
2   2   182 182 182 182 182 182 182 182 182 182 182 182 182 182 182 182 182 2   2
11 0 15
12 20 15 
53 12 12
54 12 8
55 12 4
56 16 4
57 16 8
58 8 12
59 8 8
60 4 4
61 4 10
62 8 4
63 8 21
64 12 21