15 12
6 9
7
0 0
2   2   126 133 133 133 133 133 133 133 133 133 128 2   2
2   132 134 115 115 115 115 115 115 115 115 115 132 134 2
2   115 115 121 121 182 121 1   121 182 121 121 115 115 2
2   121 121 27  28  185 28  28  28  185 28  29  121 121 2
1   27  28  31  31  185 31  31  31  185 31  31  28  29  1  
2   132 128 30  31  187 188 188 188 189 31  32  126 134 2
2   2   131 30  31  31  31  31  31  31  31  32  131 2   2
2   2   131 30  31  31  31  31  31  31  31  32  131 2   2
2   2   131 30  31  31  31  31  31  31  31  32  131 2   2
2   2   131 33  34  35  126 31  127 33  34  35  131 2   2
2   2   132 127 127 127 127 34  127 127 127 127 134 2   2
2   2   2   2   2   2   2   1   2   2   2   2   2   2   2
4 7 11 
5 0 4
6 14 4
41 7 4
42 7 5
43 3 7
44 11 3