15 12
6 9
21
0 0
2   2   126 133 133 133 133 133 133 133 133 133 133 128 2
2   132 134 115 115 115 115 115 115 115 115 115 115 115 2
2   115 115 121 121 121 121 1   121 121 121 121 121 121 2
2   121 121 27  28  28  28  28  28  28  28  28  29  37  2
1   27  28  31  31  31  31  31  31  31  31  31  31  29  1  
2   132 128 30  31  31  31  31  31  31  31  32  126 134 2
2   2   131 30  31  31  31  31  31  31  31  32  131 2   2
2   2   131 30  31  31  31  31  31  31  31  32  131 2   2
2   2   131 30  31  31  31  31  31  31  31  32  131 2   2
2   2   131 33  34  35  126 31  127 33  34  35  131 2   2
2   2   132 127 127 127 127 34  127 127 127 127 134 2   2
2   2   2   2   2   2   2   1   2   2   2   2   2   2   2
4 7 11 
5 0 4
6 14 4
41 7 4
42 7 5
43 3 7
44 11 4
90 4 1
103 12 3
104 12 4
105 13 1
108 5 2
111 5 3
111 5 4
114 5 5
115 6 5
115 8 5
116 9 5
108 9 2
111 9 3
111 9 4
