11 13
1 6
9
0 0
2   181 188 188 188 188 188 188 188 188 181 
2   186 170 170 170 170 170 170 170 170 186
2   186 176 176 176 176 176 176 176 176 186
2   186 91  91  91  91  91  91  91  91  186
2   186 91  91  91  91  91  91  91  91  186
2   170 91  91  91  91  91  91  91  91  186
2   176 29  91  91  91  91  91  91  91  186
1   28  32  91  91  91  91  91  91  91  186
2   186 35  91  91  91  91  91  91  91  186
2   186 91  91  91  91  91  91  91  91  186
2   186 91  91  91  91  91  91  91  91  186
2   186 91  91  91  91  91  91  91  91  186
2   187 188 188 188 188 188 188 188 188 189
35 0 7
66 5 4
67 5 5
67 6 4
67 6 5
67 7 4
67 7 5
67 8 4
67 8 5
