30 36
6 9
3
0 0
181 188 188 188 188 188 188 188 188 183 2   2   2   2   2   2   2   2   2   2   181 188 188 188 188 188 188 188 188 183
186 170 170 170 170 170 170 170 170 186 2   2   2   2   2   2   2   2   2   2   186 170 170 170 170 170 170 170 170 186
186 176 176 176 176 176 176 176 176 186 2   2   2   2   2   2   2   2   2   2   186 176 176 176 176 176 176 176 176 186
186 91  91  91  91  91  91  91  91  186 2   2   2   2   2   2   2   2   2   2   186 91  91  91  91  91  91  91  91  186
186 91  91  91  91  91  91  91  91  186 2   2   2   2   2   2   2   2   2   2   186 91  91  91  91  91  91  91  91  186
186 91  91  91  91  91  91  91  91  170 2   2   2   2   2   2   2   2   2   2   170 91  91  91  91  91  91  91  91  186
186 91  91  91  91  91  91  91  91  176 2   2   2   2   2   2   2   2   2   2   176 91  91  91  91  91  91  91  91  186
186 91  91  91  91  91  91  91  91  91  1   2   2   2   2   2   2   2   2   1   91  91  91  91  91  91  91  91  91  186
186 91  91  91  91  91  91  91  91  186 2   2   2   2   2   2   2   2   2   2   186 91  91  91  91  91  91  91  91  186
186 91  91  91  91  91  91  91  91  186 2   2   2   2   2   2   2   2   2   2   186 91  91  91  91  91  91  91  91  186
186 91  91  91  91  91  91  91  91  186 2   2   2   2   2   2   2   2   2   2   186 91  91  91  91  91  91  91  91  186
186 91  91  91  91  91  91  91  91  186 2   2   2   2   2   2   2   2   2   2   186 91  91  91  91  91  91  91  91  186
187 188 188 188 188 188 188 188 188 189 2   2   2   2   2   2   2   2   2   2   187 188 188 188 188 188 188 188 188 189
2   2   2   2   2   2   2   2   2   2   2   2   2   2   2   2   2   2   2   2   2   2   2   1   2   2   2   2   2   2  
2   2   2   2   2   2   2   2   2   2   2   2   2   2   2   2   2   2   2   2   2   2   2   2   2   2   2   2   2   2 
2   2   2   2   2   2   2   2   2   2   2   2   2   2   2   2   2   2   2   2   2   2   2   2   2   2   2   2   2   2 
2   2   2   2   2   2   2   2   2   2   2   2   2   2   2   2   2   2   2   2   2   2   2   2   2   2   2   2   2   2 
2   2   2   2   2   2   2   2   2   2   2   2   2   2   2   2   2   2   2   2   2   2   2   2   2   2   2   2   2   2 
2   2   2   2   2   2   2   2   2   2   2   2   2   2   2   2   2   2   2   2   2   2   2   2   2   2   2   2   2   2 
2   2   2   2   2   2   2   2   2   2   2   2   2   2   2   2   2   2   2   2   2   2   2   2   2   2   2   2   2   2 
2   2   2   2   2   2   2   2   2   2   2   2   2   2   2   2   2   2   2   2   2   2   2   2   2   2   2   2   2   2 
2   2   2   2   2   2   2   2   2   2   2   2   2   2   2   2   2   2   2   2   2   2   2   2   2   2   2   2   2   2 
2   2   2   2   2   2   2   2   2   2   2   2   2   2   2   2   2   2   2   2   2   2   2   2   2   2   2   2   2   2 
181 188 188 188 188 188 188 188 188 183 2   2   2   2   2   2   2   2   2   2   2   2   2   2   2   2   2   2   2   2  
186 170 170 170 170 170 170 170 170 186 2   2   2   2   2   2   2   2   2   2   2   2   2   2   2   2   2   2   2   2  
186 176 176 176 176 176 176 176 176 186 2   2   2   2   2   2   2   2   2   2   2   2   2   2   2   2   2   2   2   2  
186 91  91  91  91  91  91  91  91  186 2   2   2   2   2   2   2   2   2   2   2   2   2   2   2   2   2   2   2   2
186 91  91  91  91  91  91  91  91  186 2   2   2   2   2   2   2   2   2   2   2   2   2   2   2   2   2   2   2   2
186 91  91  91  91  91  91  91  91  170 2   2   2   2   2   2   2   2   2   2   2   2   2   2   2   2   2   2   2   2
186 91  91  91  91  91  91  91  91  176 2   2   2   2   2   2   2   2   2   2   2   2   2   2   2   2   2   2   2   2
186 91  91  91  91  91  91  91  91  91  1   2   2   2   2   2   2   2   2   2   2   2   2   2   2   2   2   2   2   2
186 91  91  91  91  91  91  91  91  186 2   2   2   2   2   2   2   2   2   2   2   2   2   2   2   2   2   2   2   2
186 91  91  91  91  91  91  91  91  186 2   2   2   2   2   2   2   2   2   2   2   2   2   2   2   2   2   2   2   2
186 91  91  91  91  91  91  91  91  186 2   2   2   2   2   2   2   2   2   2   2   2   2   2   2   2   2   2   2   2
186 91  91  91  91  91  91  91  91  186 2   2   2   2   2   2   2   2   2   2   2   2   2   2   2   2   2   2   2   2
187 188 188 188 188 188 188 188 188 189 2   2   2   2   2   2   2   2   2   2   2   2   2   2   2   2   2   2   2   2
25 10 7
26 10 30
27 19 7
