57 41
3 13
43
4 5
2   2   2   2   2   2   181 188 188 188 188 188 188 188 188 188 188 188 1   188 188 188 188 188 188 188 1   188 188 188 188 188 188 188 188 188 1   188 188 188 188 188 188 2   2   2   2   2   2   2   2   2   2   2   2   2   2
2   188 188 188 188 188 188 170 170 170 170 170 170 170 170 170 170 170 91  170 170 170 170 170 170 170 91  170 170 170 170 170 170 170 170 170 91  170 170 170 170 170 170 2   2   2   2   2   2   2   2   2   2   2   2   2   2
2   170 170 170 170 170 170 176 176 176 176 176 176 176 176 176 176 176 91  176 176 176 176 176 176 176 91  176 176 176 176 176 176 176 176 176 91  176 176 176 176 176 176 2   2   2   2   2   2   2   2   2   2   2   2   2   2
2   176 176 176 176 176 176 91  91  91  91  91  91  91  91  91  91  91  91  91  91  91  91  91  91  91  91  91  91  91  91  91  91  91  91  91  91  91  91  91  91  28  29  1   2   2   2   2   2   2   2   2   2   2   2   2   2
1   91  91  91  91  91  91  91  91  91  91  91  91  91  91  91  91  91  91  91  91  91  91  91  91  91  91  91  91  91  91  91  91  91  91  91  91  91  91  91  91  181 188 2   2   2   2   2   2   2   2   2   2   2   2   2   2
2   188 183 91  91  91  184 91  91  91  91  91  91  91  91  91  91  91  91  91  91  91  91  91  91  91  91  91  91  91  91  91  91  91  91  91  91  91  91  91  91  184 2   2   2   2   2   2   2   2   2   2   2   2   2   2   2
2   2   184 91  91  91  184 91  91  91  91  91  91  91  91  91  181 188 188 188 188 188 188 188 188 188 188 188 188 188 188 188 188 188 188 188 188 183 91  91  91  184 2   2   2   2   2   2   2   2   2   2   2   2   2   2   2
2   2   184 91  91  91  184 91  91  91  91  91  91  91  91  91  184 2   2   2   2   2   2   2   2   2   2   2   2   2   2   2   2   2   2   2   2   186 91  91  91  184 2   2   2   2   2   2   2   2   2   2   2   2   2   2   2
2   2   184 91  91  91  184 91  91  91  91  91  91  91  91  91  184 2   2   2   2   2   2   2   2   2   2   2   2   2   2   2   2   2   2   2   2   186 91  91  91  184 2   2   2   2   2   2   2   2   2   2   2   2   2   2   2
2   2   184 91  91  91  184 91  91  91  91  91  91  91  91  91  184 2   2   2   2   2   2   2   2   2   2   2   2   2   2   2   2   2   2   2   2   186 91  91  91  187 188 188 188 188 188 188 188 188 188 188 188 183 2   2   2
2   2   184 91  91  91  184 188 188 188 188 188 188 188 188 188 189 2   2   2   2   2   2   2   2   2   2   2   2   2   2   2   2   2   2   2   2   186 91  91  91  170 170 170 170 170 170 170 170 170 170 170 170 184 2   2   2
2   2   184 91  91  91  184 2   2   2   2   2   2   2   2   2   2   2   2   2   2   2   2   2   2   2   2   2   2   2   2   2   2   2   2   2   2   186 91  91  91  176 176 176 176 176 176 176 176 176 176 176 176 184 2   2   2
2   2   184 91  91  91  184 2   2   2   2   2   2   2   2   2   2   2   2   2   2   2   2   2   2   2   2   2   2   2   2   2   2   2   2   2   2   186 91  91  91  91  91  91  91  91  91  91  91  91  91  91  91  184 2   2   2
2   2   184 1   1   1   184 2   2   2   2   2   2   2   2   2   2   2   2   2   2   2   2   2   2   2   2   2   2   2   2   2   2   2   2   2   2   186 91  91  91  91  91  91  91  91  91  91  91  91  91  91  91  184 2   2   2
2   2   184 2   2   2   184 2   2   2   2   2   2   2   2   2   2   2   2   2   2   2   2   2   2   2   2   2   2   2   2   2   2   2   2   2   2   186 91  91  91  91  91  91  91  91  91  91  91  91  91  91  91  184 2   2   2
2   2   188 2   2   2   188 2   2   2   2   2   2   2   2   2   2   2   2   2   2   2   2   2   2   2   2   2   2   2   2   2   2   2   2   2   2   186 91  91  91  91  91  91  91  91  91  91  91  91  91  91  91  184 2   2   2
2   2   2   2   2   2   2   2   2   2   2   2   2   2   2   2   2   2   2   2   2   2   2   2   2   2   2   2   2   2   2   2   2   2   2   2   2   186 91  91  91  91  91  91  91  91  91  91  91  91  91  91  91  184 2   2   2
2   2   2   2   2   2   2   2   2   2   2   2   2   2   2   2   2   2   2   2   2   2   2   2   2   2   2   2   2   2   2   2   2   2   2   2   2   186 91  91  91  91  91  91  91  91  91  91  91  91  91  91  91  184 2   2   2
2   2   2   2   2   2   2   2   2   2   2   2   2   2   2   2   2   2   2   2   2   2   2   2   2   2   2   2   2   2   2   2   2   2   2   2   2   187 188 188 188 188 188 188 188 183 91  91  91  91  91  91  91  184 2   2   2
2   2   2   2   2   2   2   2   2   2   2   2   2   2   2   2   2   2   2   2   2   2   2   2   2   2   2   2   2   2   2   2   2   2   2   2   2   2   2   2   2   2   2   2   2   186 91  91  91  91  91  91  91  184 2   2   2
2   2   2   2   2   2   2   2   2   2   2   2   2   2   2   2   2   2   2   2   2   2   2   2   2   2   2   2   2   2   2   2   2   2   2   2   2   2   2   2   2   2   2   2   2   186 91  91  91  91  91  91  91  184 2   2   2
2   2   2   2   2   2   2   2   2   2   2   2   2   2   2   2   2   2   2   2   2   2   2   2   2   2   2   2   2   2   2   2   2   2   2   2   2   2   2   2   2   2   2   2   2   186 91  91  91  91  91  91  91  184 2   2   2
2   2   2   2   2   2   2   2   2   2   2   2   2   2   2   2   2   2   2   2   2   2   2   2   2   2   2   2   2   2   2   2   2   2   2   2   2   2   2   2   2   2   2   2   2   186 91  91  91  91  91  91  91  184 2   2   2
2   2   2   2   2   2   2   2   2   2   2   2   2   2   2   2   2   2   2   2   2   2   2   2   2   2   2   2   2   2   2   2   2   2   2   2   2   2   2   2   2   2   2   2   2   186 91  91  91  91  91  91  91  184 2   2   2
2   2   2   2   2   2   2   2   2   2   2   2   2   2   2   2   2   2   2   2   2   2   2   2   2   2   2   2   2   2   2   2   2   2   2   2   2   2   2   2   2   2   2   2   2   186 91  91  91  91  91  91  91  184 2   2   2
2   2   2   2   2   2   2   2   2   2   2   2   2   2   2   2   2   2   2   2   2   2   2   2   2   2   2   2   2   2   2   2   2   2   2   2   2   2   2   2   2   2   2   2   2   186 91  91  91  91  91  91  91  184 2   2   2
2   2   2   2   2   2   2   2   2   2   2   2   2   2   2   2   2   2   2   2   2   2   2   2   2   2   2   2   2   2   2   2   2   2   2   2   2   2   2   2   2   2   2   2   2   186 91  91  91  91  91  91  91  184 2   2   2
2   2   2   2   2   2   2   2   2   2   2   2   2   2   2   2   2   2   2   2   2   2   2   2   2   2   2   2   2   2   2   2   2   2   2   2   2   2   2   2   2   2   2   2   2   186 91  91  91  91  91  91  91  184 2   2   2
2   2   2   2   2   2   2   2   2   2   2   2   2   2   2   2   2   2   2   2   2   2   2   2   2   2   2   2   2   2   2   2   2   2   2   2   2   2   2   2   2   2   2   2   2   186 91  91  91  91  91  91  91  184 2   2   2
2   2   2   2   2   2   2   2   2   2   2   2   2   2   2   2   2   2   2   2   2   2   2   2   2   2   2   2   2   2   2   2   2   2   2   2   2   2   2   2   2   2   2   2   2   186 91  91  91  91  91  91  91  184 2   2   2
2   2   2   2   2   2   2   2   2   2   2   2   2   2   2   2   2   2   2   2   2   2   2   2   2   2   2   2   2   2   2   2   2   2   2   2   2   2   2   2   2   2   2   2   2   186 91  91  91  91  91  91  91  184 2   2   2
2   2   2   2   2   2   2   2   2   2   2   2   2   2   2   2   2   2   2   2   2   2   2   2   2   2   2   2   2   2   2   2   2   2   2   2   2   2   2   2   2   2   2   2   2   186 91  91  91  91  91  91  91  184 2   2   2
2   2   2   2   2   2   2   2   2   2   2   2   2   2   2   2   2   2   2   2   2   2   2   2   2   2   2   2   2   2   2   2   2   2   2   2   2   2   2   2   2   2   2   2   2   186 91  91  91  91  91  91  91  184 2   2   2
2   2   2   2   2   2   2   2   2   2   2   2   2   2   2   2   2   2   2   2   2   2   2   2   2   2   2   2   2   2   2   2   2   2   2   2   2   2   2   2   2   2   2   2   2   186 91  91  91  91  91  188 188 184 2   2   2
2   2   2   2   2   2   2   2   2   2   2   2   2   2   2   2   2   2   2   2   2   2   2   2   2   2   2   2   2   2   2   2   2   2   2   2   2   2   2   2   2   2   2   2   181 188 91  91  91  91  91  176 176 188 183 2   2
2   2   2   2   2   2   2   2   2   2   2   2   2   2   2   2   2   2   2   2   2   2   2   2   2   2   2   2   2   2   2   2   2   2   2   2   2   2   2   2   2   2   2   188 188 170 91  91  91  91  91  91  91  170 188 188 2
2   2   2   2   2   2   2   2   2   2   2   2   2   2   2   2   2   2   2   2   2   2   2   2   2   2   2   2   2   2   2   2   2   2   2   2   2   2   2   2   2   2   2   170 170 176 91  91  91  91  91  91  91  176 170 170 2
2   2   2   2   2   2   2   2   2   2   2   2   2   2   2   2   2   2   2   2   2   2   2   2   2   2   2   2   2   2   2   2   2   2   2   2   2   2   2   2   2   2   2   176 176 91  91  91  91  91  91  91  91  91  176 176 2
2   2   2   2   2   2   2   2   2   2   2   2   2   2   2   2   2   2   2   2   2   2   2   2   2   2   2   2   2   2   2   2   2   2   2   2   2   2   2   2   2   2   1   91  91  91  91  91  91  91  91  91  91  91  91  91  1   
2   2   2   2   2   2   2   2   2   2   2   2   2   2   2   2   2   2   2   2   2   2   2   2   2   2   2   2   2   2   2   2   2   2   2   2   2   2   2   2   2   2   2   186 186 91  91  91  91  91  91  91  91  91  181 181 2
2   2   2   2   2   2   2   2   2   2   2   2   2   2   2   2   2   2   2   2   2   2   2   2   2   2   2   2   2   2   2   2   2   2   2   2   2   2   2   2   2   2   2   2   187 186 188 188 188 188 188 188 188 188 189 2   2
20 3 14
20 4 14
20 5 14
20 3 13
20 4 13
20 5 13
21 42 38
28 18 0
29 26 0
38 36 0   
32 0 4
33 43 3
36 56 38
108 49 11
111 49 12
111 49 13
114 49 14
115 50 14
116 51 14
95 46 21
101 47 21
95 51 21
101 52 21
95 46 25
101 47 25
95 51 25
101 52 25
95 46 29
101 47 29
95 51 29
101 52 29
128 7 7
129 21 5
130 15 9
131 46 22
132 51 22
133 46 26
134 51 26
136 46 30
135 51 30
138 40 3
145 17 2
144 27 2
4 5
11 5
1 10
8 10
7 10
