30 11
6 9
2
25 2
181 188 188 188 188 188 188 188 188 183 2   2   2   2   2   2   2   2   2   2  181 188 188 188 188 188 188 188 188 183
186 170 170 170 170 170 170 170 170 186 2   2   2   2   2   2   2   2   2   2  186 170 170 170 170 170 170 170 170 186
186 176 176 176 176 176 176 176 176 186 2   2   2   2   2   2   2   2   2   2  186 176 176 176 176 176 176 176 176 186
186 14  14  14  14  14  14  14  14  186 2   2   2   2   2   2   2   2   2   2  186 14  14  14  14  14  14  14  14  186
186 14  14  14  14  14  14  14  14  186 2   2   2   2   2   2   2   2   2   2  186 14  14  14  14  14  14  14  14  186
186 14  14  14  14  14  14  14  14  186 2   2   2   2   2   2   2   2   2   2  186 14  14  14  14  14  14  14  14  186
186 14  14  14  14  14  14  14  14  186 2   2   2   2   2   2   2   2   2   2  186 14  14  14  14  14  14  14  14  186
186 14  14  14  14  14  14  14  14  186 2   2   2   2   2   2   2   2   2   2  186 14  14  14  14  14  14  14  14  186
186 14  14  14  14  14  14  14  14  186 2   2   2   2   2   2   2   2   2   2  186 14  14  14  14  14  14  14  14  186
187 188 188 188 188 188 14  188 188 189 2   2   2   2   2   2   2   2   2   2  187 188 188 14  188 188 188 188 188 189
2   2   2   2   2   2   1   2   2   2   2   2   2   2   2   2   2   2   2   2  2   2   2   1   2   2   2   2   2   2  
30 6 10
31 23 10
6 10
2 20
