57 41
3 13
9
0 0
2   2   2   2   2   2   181 188 188 188 188 188 188 188 188 188 188 188 1   188 188 188 188 188 188 188 1   188 188 188 188 188 188 188 188 188 188 188 188 188 188 188 188 2   2   2   2   2   2   2   2   2   2   2   2   2   2
2   188 188 188 188 188 188 170 170 170 170 170 170 170 170 170 170 170 91  170 170 170 170 170 170 170 91  170 170 170 170 170 170 170 170 170 170 170 170 170 170 170 170 2   2   2   2   2   2   2   2   2   2   2   2   2   2
2   170 170 170 170 170 170 176 176 176 176 176 176 176 176 176 176 176 91  176 176 176 176 176 176 176 91  176 176 176 176 176 176 176 176 176 176 176 176 176 176 176 176 2   2   2   2   2   2   2   2   2   2   2   2   2   2
2   176 176 176 176 176 176 91  91  91  91  91  91  91  91  91  91  91  91  91  91  91  91  91  91  91  91  91  91  91  91  91  91  91  91  91  91  91  91  91  91  28  29  1   2   2   2   2   2   2   2   2   2   2   2   2   2
1   91  91  91  91  91  91  91  91  91  91  91  91  91  91  91  91  91  91  91  91  91  91  91  91  91  91  91  91  91  91  91  91  91  91  91  91  91  91  91  91  181 188 2   2   2   2   2   2   2   2   2   2   2   2   2   2
2   188 183 91  91  91  184 91  91  91  91  91  91  91  91  91  91  91  91  91  91  91  91  91  91  91  91  91  91  91  91  91  91  91  91  91  91  91  91  91  91  184 2   2   2   2   2   2   2   2   2   2   2   2   2   2   2
2   2   184 91  91  91  184 91  91  91  91  91  91  91  91  91  181 188 188 188 188 188 188 188 188 188 188 188 188 188 188 188 188 188 188 188 188 183 91  91  91  184 2   2   2   2   2   2   2   2   2   2   2   2   2   2   2
2   2   184 91  91  91  184 91  91  91  91  91  91  91  91  91  184 2   2   2   2   2   2   2   2   2   2   2   2   2   2   2   2   2   2   2   2   186 91  91  91  184 2   2   2   2   2   2   2   2   2   2   2   2   2   2   2
2   2   184 91  91  91  184 91  91  91  91  91  91  91  91  91  184 2   2   2   2   2   2   2   2   2   2   2   2   2   2   2   2   2   2   2   2   186 91  91  91  184 2   2   2   2   2   2   2   2   2   2   2   2   2   2   2
2   2   184 91  91  91  184 91  91  91  91  91  91  91  91  91  184 2   2   2   2   2   2   2   2   2   2   2   2   2   2   2   2   2   2   2   2   186 91  91  91  187 188 188 188 188 188 188 188 188 188 188 188 183 2   2   2
2   2   184 91  91  91  184 188 188 188 188 188 188 188 188 188 189 2   2   2   2   2   2   2   2   2   2   2   2   2   2   2   2   2   2   2   2   186 91  91  91  170 170 170 170 170 170 170 170 170 170 170 170 184 2   2   2
2   2   184 91  91  91  184 2   2   2   2   2   2   2   2   2   2   2   2   2   2   2   2   2   2   2   2   2   2   2   2   2   2   2   2   2   2   186 91  91  91  176 176 176 176 176 176 176 176 186 176 176 176 184 2   2   2
2   2   184 91  91  91  184 2   2   2   2   2   2   2   2   2   2   2   2   2   2   2   2   2   2   2   2   2   2   2   2   2   2   2   2   2   2   186 91  91  91  91  91  91  91  91  91  91  91  186 91  91  91  184 2   2   2
2   2   184 91  91  91  184 2   2   2   2   2   2   2   2   2   2   2   2   2   2   2   2   2   2   2   2   2   2   2   2   2   2   2   2   2   2   186 91  91  91  91  91  91  91  91  91  91  91  186 91  91  91  184 2   2   2
2   2   184 1   1   1   184 2   2   2   2   2   2   2   2   2   2   2   2   2   2   2   2   2   2   2   2   2   2   2   2   2   2   2   2   2   2   186 91  91  91  91  91  91  91  91  91  91  91  188 188 188 91  184 2   2   2
2   2   2   2   2   2   2   2   2   2   2   2   2   2   2   2   2   2   2   2   2   2   2   2   2   2   2   2   2   2   2   2   2   2   2   2   2   186 91  91  91  91  91  91  91  91  91  91  91  91  91  91  91  184 2   2   2
2   2   2   2   2   2   2   2   2   2   2   2   2   2   2   2   2   2   2   2   2   2   2   2   2   2   2   2   2   2   2   2   2   2   2   2   2   186 91  91  91  91  91  91  91  91  91  91  91  91  91  91  91  184 2   2   2
2   2   2   2   2   2   2   2   2   2   2   2   2   2   2   2   2   2   2   2   2   2   2   2   2   2   2   2   2   2   2   2   2   2   2   2   2   186 91  91  91  91  91  91  91  91  91  91  91  91  91  91  91  184 2   2   2
2   2   2   2   2   2   2   2   2   2   2   2   2   2   2   2   2   2   2   2   2   2   2   2   2   2   2   2   2   2   2   2   2   2   2   2   2   187 188 188 188 188 188 188 188 183 91  91  91  91  91  91  91  184 2   2   2
2   2   2   2   2   2   2   2   2   2   2   2   2   2   2   2   2   2   2   2   2   2   2   2   2   2   2   2   2   2   2   2   2   2   2   2   2   2   2   2   2   2   2   2   2   186 91  91  91  91  91  91  91  184 2   2   2
2   2   2   2   2   2   2   2   2   2   2   2   2   2   2   2   2   2   2   2   2   2   2   2   2   2   2   2   2   2   2   2   2   2   2   2   2   2   2   2   2   2   2   2   2   186 91  91  91  91  91  91  91  184 2   2   2
2   2   2   2   2   2   2   2   2   2   2   2   2   2   2   2   2   2   2   2   2   2   2   2   2   2   2   2   2   2   2   2   2   2   2   2   2   2   2   2   2   2   2   2   2   186 188 188 91  91  91  188 188 184 2   2   2
2   2   2   2   2   2   2   2   2   2   2   2   2   2   2   2   2   2   2   2   2   2   2   2   2   2   2   2   2   2   2   2   2   2   2   2   2   2   2   2   2   2   2   2   2   186 176 176 91  91  91  176 176 184 2   2   2
2   2   2   2   2   2   2   2   2   2   2   2   2   2   2   2   2   2   2   2   2   2   2   2   2   2   2   2   2   2   2   2   2   2   2   2   2   2   2   2   2   2   2   2   2   186 91  91  91  91  91  91  91  184 2   2   2
2   2   2   2   2   2   2   2   2   2   2   2   2   2   2   2   2   2   2   2   2   2   2   2   2   2   2   2   2   2   2   2   2   2   2   2   2   2   2   2   2   2   2   2   2   186 91  91  91  91  91  91  91  184 2   2   2
2   2   2   2   2   2   2   2   2   2   2   2   2   2   2   2   2   2   2   2   2   2   2   2   2   2   2   2   2   2   2   2   2   2   2   2   2   2   2   2   2   2   2   2   2   186 188 188 91  91  91  188 188 184 2   2   2
2   2   2   2   2   2   2   2   2   2   2   2   2   2   2   2   2   2   2   2   2   2   2   2   2   2   2   2   2   2   2   2   2   2   2   2   2   2   2   2   2   2   2   2   2   186 176 176 91  91  91  176 176 184 2   2   2
2   2   2   2   2   2   2   2   2   2   2   2   2   2   2   2   2   2   2   2   2   2   2   2   2   2   2   2   2   2   2   2   2   2   2   2   2   2   2   2   2   2   2   2   2   186 91  91  91  91  91  91  91  184 2   2   2
2   2   2   2   2   2   2   2   2   2   2   2   2   2   2   2   2   2   2   2   2   2   2   2   2   2   2   2   2   2   2   2   2   2   2   2   2   2   2   2   2   2   2   2   2   186 91  91  91  91  91  91  91  184 2   2   2
2   2   2   2   2   2   2   2   2   2   2   2   2   2   2   2   2   2   2   2   2   2   2   2   2   2   2   2   2   2   2   2   2   2   2   2   2   2   2   2   2   2   2   2   2   186 188 188 91  91  91  188 188 184 2   2   2
2   2   2   2   2   2   2   2   2   2   2   2   2   2   2   2   2   2   2   2   2   2   2   2   2   2   2   2   2   2   2   2   2   2   2   2   2   2   2   2   2   2   2   2   2   186 176 176 91  91  91  176 176 184 2   2   2
2   2   2   2   2   2   2   2   2   2   2   2   2   2   2   2   2   2   2   2   2   2   2   2   2   2   2   2   2   2   2   2   2   2   2   2   2   2   2   2   2   2   2   2   2   186 91  91  91  91  91  91  91  184 2   2   2
2   2   2   2   2   2   2   2   2   2   2   2   2   2   2   2   2   2   2   2   2   2   2   2   2   2   2   2   2   2   2   2   2   2   2   2   2   2   2   2   2   2   2   2   2   186 91  91  91  91  91  91  91  184 2   2   2
2   2   2   2   2   2   2   2   2   2   2   2   2   2   2   2   2   2   2   2   2   2   2   2   2   2   2   2   2   2   2   2   2   2   2   2   2   2   2   2   2   2   2   2   2   186 91  91  91  91  91  188 188 184 2   2   2
2   2   2   2   2   2   2   2   2   2   2   2   2   2   2   2   2   2   2   2   2   2   2   2   2   2   2   2   2   2   2   2   2   2   2   2   2   2   2   2   2   2   2   2   181 188 91  91  91  91  91  176 176 188 183 2   2
2   2   2   2   2   2   2   2   2   2   2   2   2   2   2   2   2   2   2   2   2   2   2   2   2   2   2   2   2   2   2   2   2   2   2   2   2   2   2   2   2   2   2   188 188 170 91  91  91  91  91  91  91  170 188 188 2
2   2   2   2   2   2   2   2   2   2   2   2   2   2   2   2   2   2   2   2   2   2   2   2   2   2   2   2   2   2   2   2   2   2   2   2   2   2   2   2   2   2   2   170 170 176 91  91  91  91  91  91  91  176 170 170 2
2   2   2   2   2   2   2   2   2   2   2   2   2   2   2   2   2   2   2   2   2   2   2   2   2   2   2   2   2   2   2   2   2   2   2   2   2   2   2   2   2   2   2   176 176 91  91  91  91  91  91  91  91  91  176 176 2
2   2   2   2   2   2   2   2   2   2   2   2   2   2   2   2   2   2   2   2   2   2   2   2   2   2   2   2   2   2   2   2   2   2   2   2   2   2   2   2   2   2   1   91  91  91  91  91  91  91  91  91  91  91  91  91  1   
2   2   2   2   2   2   2   2   2   2   2   2   2   2   2   2   2   2   2   2   2   2   2   2   2   2   2   2   2   2   2   2   2   2   2   2   2   2   2   2   2   2   2   186 186 91  91  91  91  91  91  91  91  91  181 181 2
2   2   2   2   2   2   2   2   2   2   2   2   2   2   2   2   2   2   2   2   2   2   2   2   2   2   2   2   2   2   2   2   2   2   2   2   2   2   2   2   2   2   2   2   187 186 188 188 188 188 188 188 188 188 189 2   2
20 3 14
20 4 14
20 5 14
21 42 38
28 18 0
29 26 0
32 0 4
33 43 3
36 56 38