13 16
6 10
1
0
0 0
1	1	1	1	1	1	1	1	1	1	1	1	1
1	1	1	1	1	1	1	1	1	1	1	1	1
1	1	1	1	1	1	1	1	1	1	1	1	1
1	1	1	29	29	29	29	29	29	29	1	1	1
1	1	1	29	30	30	30	30	30	29	1	1	1
1	1	1	29	30	30	30	30	30	29	1	1	1
1	1	1	29	30	30	30	30	30	29	1	1	1
1	1	1	29	39	39	39	39	39	29	1	1	1
1	1	1	29	39	39	39	39	39	29	1	1	1
1	1	1	29	39	39	39	39	39	29	1	1	1
1	1	1	29	39	39	39	39	39	29	1	1	1
1	1	1	29	39	39	39	39	39	29	1	1	1
1	1	1	29	29	29	29	29	29	29	1	1	1
1	1	1	1	1	1	1	1	1	1	1	1	1
1	1	1	1	1	1	1	1	1	1	1	1	1
1	1	1	1	1	1	1	1	1	1	1	1	1
761 6 11
18