30 47
10 42
9
14
0 0
1	1	1	1	1	1	1	1	1	1	1	1	1	1	1	1	1	1	1	1	1	1	1	1	1	1	1	1	1	1
1	1	1	1	1	1	1	1	1	1	1	1	1	1	1	1	1	1	1	1	1	1	1	1	1	1	1	1	1	1
1	1	1	1	1	1	1	1	1	1	1	1	1	1	1	1	1	1	1	1	1	1	1	1	1	1	1	1	1	1
1	1	1	1	1	1	1	1	1	1	1	30	30	30	30	30	30	30	30	1	1	1	1	1	1	1	1	1	1	1
1	1	1	1	1	1	1	1	1	1	1	30	31	31	31	31	31	31	30	1	1	1	1	1	1	1	1	1	1	1
1	1	1	1	1	1	1	1	1	1	1	30	31	31	31	31	31	31	30	1	1	1	1	1	1	1	1	1	1	1
1	1	1	1	1	1	1	1	1	1	1	31	31	31	31	31	31	31	31	1	1	1	1	1	1	1	1	1	1	1
1	1	1	1	1	1	1	1	1	30	30	30	39	39	39	39	39	39	30	30	30	1	1	1	1	1	1	1	1	1
1	1	1	1	1	1	1	1	1	30	31	31	39	39	39	39	39	39	31	31	30	1	1	1	1	1	1	1	1	1
1	1	1	1	1	1	1	1	1	30	31	31	39	39	39	39	39	39	31	31	30	1	1	1	1	1	1	1	1	1
1	1	1	1	1	1	1	1	1	30	31	31	31	31	18	18	31	31	31	31	30	1	1	1	1	1	1	1	1	1
1	1	1	1	1	1	1	1	1	30	39	39	39	39	39	39	39	39	39	39	30	1	1	1	1	1	1	1	1	1
1	1	1	1	1	1	1	1	1	30	39	39	39	39	39	39	39	39	39	39	30	1	1	1	1	1	1	1	1	1
1	1	1	1	1	1	1	1	1	30	39	39	39	39	39	39	39	39	39	39	30	1	1	1	1	1	1	1	1	1
1	1	1	1	1	1	1	1	1	30	39	39	39	39	39	39	39	39	39	39	30	1	1	1	1	1	1	1	1	1
1	1	1	1	1	1	1	1	1	30	39	39	39	39	39	39	39	39	39	39	30	1	1	1	1	1	1	1	1	1
1	1	1	1	1	1	1	1	1	30	39	39	39	39	39	39	39	39	39	39	30	1	1	1	1	1	1	1	1	1
1	1	1	1	1	1	1	1	1	30	39	39	39	39	39	39	39	39	39	39	30	1	1	1	1	1	1	1	1	1
1	1	1	1	1	1	1	1	1	30	39	39	39	39	39	39	39	39	39	39	30	1	1	1	1	1	1	1	1	1
1	1	1	1	1	1	1	1	1	30	30	30	30	39	39	39	39	30	30	30	30	1	1	1	1	1	1	1	1	1
1	1	1	1	1	1	1	1	1	1	1	1	30	39	39	39	39	30	1	1	1	1	1	1	1	1	1	1	1	1
1	1	1	1	1	1	1	1	30	30	30	30	30	39	39	39	39	30	30	30	30	30	1	1	1	1	1	1	1	1
1	1	1	1	1	1	1	1	30	31	31	31	31	39	39	39	39	31	31	31	31	30	1	1	1	1	1	1	1	1
1	1	1	30	30	30	30	30	30	31	31	31	31	39	39	39	39	31	31	31	31	30	30	30	30	30	30	1	1	1
1	1	1	30	31	31	31	31	31	31	31	31	31	39	39	39	39	31	31	31	31	31	31	31	31	31	30	1	1	1
1	1	1	30	31	31	31	31	31	39	39	31	31	39	39	39	39	31	31	39	39	31	31	31	31	31	30	1	1	1
1	1	1	30	31	31	31	31	31	39	39	21	31	39	39	39	39	31	20	39	39	31	31	31	31	31	30	1	1	1
1	1	1	30	39	39	39	39	39	39	30	30	21	39	39	39	39	20	30	30	39	39	39	39	39	39	30	1	1	1
1	1	1	30	39	39	39	39	39	39	30	30	30	39	39	39	39	30	30	30	39	39	39	39	39	39	30	1	1	1
1	1	1	30	39	39	39	39	39	39	30	39	39	39	39	39	39	39	39	30	39	39	39	39	39	39	30	1	1	1
1	1	1	30	39	39	39	39	39	39	30	30	30	30	30	30	30	30	30	30	39	39	39	39	39	39	30	1	1	1
1	1	1	30	39	39	39	39	39	39	31	31	31	31	31	31	31	31	31	31	39	39	39	39	39	39	30	1	1	1
1	1	1	30	39	39	39	39	39	39	31	31	31	31	31	31	31	31	31	31	39	39	39	39	39	39	30	1	1	1
1	1	1	30	30	39	30	30	30	39	31	31	31	31	31	31	31	31	31	31	39	30	30	30	39	30	30	1	1	1
1	1	1	1	1	0	1	1	30	39	39	39	39	39	39	39	39	39	39	39	39	30	1	1	0	1	1	1	1	1
1	1	1	1	1	1	1	1	30	39	39	39	39	39	39	39	39	39	39	39	39	30	1	1	1	1	1	1	1	1
1	1	1	1	1	1	1	1	30	39	39	39	39	39	39	39	39	39	39	39	39	30	1	1	1	1	1	1	1	1
1	1	1	1	1	1	1	1	30	39	39	39	39	39	39	39	39	39	39	39	39	30	1	1	1	1	1	1	1	1
1	1	1	1	1	1	1	1	30	39	39	39	39	39	39	39	39	39	39	39	39	30	1	1	1	1	1	1	1	1
1	1	1	1	1	1	1	1	30	39	39	39	39	39	39	39	39	39	39	39	39	30	1	1	1	1	1	1	1	1
1	1	1	1	1	1	1	1	30	39	39	39	30	39	39	39	39	30	39	39	39	30	1	1	1	1	1	1	1	1
1	1	1	1	1	1	1	1	30	39	39	39	30	39	39	39	39	30	39	39	39	30	1	1	1	1	1	1	1	1
1	1	1	1	1	1	1	1	30	39	39	39	30	30	30	30	30	30	39	39	39	30	1	1	1	1	1	1	1	1
1	1	1	1	1	1	1	1	1	0	0	0	1	1	1	1	1	1	0	0	0	1	1	1	1	1	1	1	1	1
1	1	1	1	1	1	1	1	1	1	1	1	1	1	1	1	1	1	1	1	1	1	1	1	1	1	1	1	1	1
1	1	1	1	1	1	1	1	1	1	1	1	1	1	1	1	1	1	1	1	1	1	1	1	1	1	1	1	1	1
1	1	1	1	1	1	1	1	1	1	1	1	1	1	1	1	1	1	1	1	1	1	1	1	1	1	1	1	1	1
464 9 43
464 10 43
464 11 43
464 18 43
464 19 43
464 20 43
465 5 34
466 24 34
467 13 6
36 352 800
36 384 832
37 352 832
37 384 864
38 352 864
38 384 896
39 352 896
32 544 832
32 576 800
33 544 864
33 576 832
34 544 896
34 576 864
35 576 896
20
