48 31
12 22
4
0
0 0
1	1	1	1	1	1	1	1	1	1	1	1	1	1	1	1	1	1	1	1	1	1	1	1	1	1	1	1	1	1	1	1	1	1	1	1	1	1	1	1	1	1	1	1	1	1	1	1
1	1	1	1	1	1	1	1	1	1	1	1	1	1	1	1	1	1	1	1	1	1	1	1	1	1	1	1	1	1	1	1	1	1	1	1	1	1	1	1	1	1	1	1	1	1	1	1
1	1	1	1	1	1	1	1	1	1	1	1	1	1	1	1	1	1	1	1	1	1	1	1	1	1	1	1	1	1	1	1	1	1	1	1	1	1	1	1	1	1	1	1	1	1	1	1
1	1	1	1	1	1	1	1	1	1	1	1	1	1	1	1	1	1	1	1	1	1	1	1	1	1	1	1	1	1	1	39	39	39	39	21	1	1	1	1	1	1	1	1	1	1	1	1
1	1	1	1	1	1	1	1	1	1	1	1	1	1	1	1	1	1	1	1	1	1	1	1	1	1	1	1	1	1	1	39	39	39	39	1	21	1	1	1	1	1	1	1	1	1	1	1
1	1	1	1	1	1	1	1	1	1	1	1	1	1	1	1	1	1	1	1	1	1	1	1	1	1	1	1	1	1	1	39	39	39	39	1	1	21	1	39	39	39	1	1	1	1	1	1
1	1	1	1	1	1	1	1	1	1	1	1	1	1	1	1	1	1	1	1	1	1	1	1	1	1	1	1	1	1	1	39	39	39	39	1	1	1	21	39	39	39	1	1	1	1	1	1
1	1	1	1	1	1	1	1	1	1	1	1	1	1	1	1	39	39	39	1	1	1	1	1	1	1	1	1	1	1	1	39	39	39	39	1	1	1	1	1	39	1	1	1	1	1	1	1
1	1	1	1	1	1	1	1	1	1	1	1	1	1	1	1	39	39	39	1	1	1	1	1	1	1	1	1	1	1	1	39	1	1	1	1	1	1	1	1	1	1	39	39	39	1	1	1
1	1	1	1	1	1	1	1	1	1	1	1	39	39	39	39	39	39	39	1	1	1	1	1	1	1	1	1	1	1	1	39	1	1	1	1	1	1	1	1	1	1	39	39	39	1	1	1
1	1	1	1	1	1	1	1	1	1	1	1	39	1	1	1	1	1	1	1	1	1	1	1	1	1	1	1	1	1	1	39	1	1	39	39	39	39	39	39	39	39	39	39	39	1	1	1
1	1	1	1	1	1	1	1	1	1	1	1	39	1	1	1	1	1	1	1	1	1	1	1	1	31	31	31	1	1	1	39	1	1	39	1	1	1	39	1	1	1	39	1	1	1	1	1
1	1	1	1	1	1	1	1	1	1	1	1	39	39	39	39	1	1	1	1	1	1	1	1	1	31	31	31	1	1	1	39	1	1	39	1	1	1	39	1	1	1	39	1	1	1	1	1
1	1	1	1	1	1	1	1	1	1	1	1	39	1	1	39	1	1	1	1	1	1	1	1	1	39	39	39	1	1	1	39	1	1	39	1	1	39	39	1	1	1	39	1	1	1	1	1
1	1	1	1	1	1	1	1	1	1	1	1	39	1	1	39	39	39	39	39	39	39	39	39	39	39	39	39	39	39	39	39	39	39	39	1	1	39	39	1	1	1	39	1	1	1	1	1
1	1	1	1	39	39	39	39	39	39	39	39	39	1	1	1	1	1	1	39	1	1	1	1	1	39	39	39	1	1	39	1	1	1	1	1	1	1	39	1	1	1	39	1	1	1	1	1
1	1	1	1	39	39	1	1	1	39	1	1	39	1	1	1	1	1	1	39	1	1	1	1	1	1	1	1	1	1	39	1	1	1	1	1	1	1	39	1	1	1	39	1	1	1	1	1
1	1	1	1	39	39	1	1	1	39	1	1	39	1	1	1	1	1	1	39	1	1	1	1	1	1	1	1	1	1	39	1	1	1	1	1	1	1	39	1	1	1	39	1	1	1	1	1
1	1	1	1	39	39	39	1	1	39	1	1	39	1	1	1	1	1	1	39	1	1	1	1	1	1	1	1	1	1	39	1	1	1	1	1	1	1	39	1	1	1	39	1	1	1	1	1
1	1	1	1	39	39	39	1	1	39	1	1	39	1	1	1	1	1	1	39	1	1	1	1	1	1	1	1	1	1	39	1	1	1	1	1	1	1	39	1	1	1	39	1	1	1	1	1
1	1	1	1	39	39	39	1	1	1	1	1	39	1	1	1	1	1	1	39	1	1	1	1	1	1	1	1	1	1	39	1	1	1	1	1	1	1	39	39	39	39	39	1	1	1	1	1
1	1	1	1	39	39	39	1	1	1	1	1	39	1	1	1	1	1	1	39	1	1	1	1	1	1	1	1	1	1	39	1	1	1	1	1	1	1	1	39	1	1	39	1	1	1	1	1
1	1	1	1	39	39	39	1	1	1	1	1	39	1	1	1	1	1	1	39	1	1	1	1	1	1	1	1	1	1	39	1	1	1	1	1	1	1	1	39	1	1	39	1	1	1	1	1
1	1	1	1	39	39	39	39	1	1	1	1	0	1	1	1	39	39	39	39	39	39	39	39	39	39	39	1	1	1	39	1	1	1	1	1	1	1	1	39	1	1	39	1	1	1	1	1
1	1	1	1	1	1	1	39	1	1	1	1	1	1	1	1	39	1	1	1	1	1	1	1	1	1	39	39	39	39	39	1	1	1	39	39	39	39	39	39	1	1	0	1	1	1	1	1
1	1	1	1	1	1	1	39	1	1	1	1	1	1	1	1	39	1	1	1	1	1	1	1	1	1	39	39	39	39	39	1	1	1	39	1	1	1	1	1	1	1	1	1	1	1	1	1
1	1	1	1	1	1	1	39	1	1	1	1	1	1	1	1	39	1	1	1	39	39	1	1	1	1	39	39	39	39	39	1	1	1	39	1	1	1	1	1	1	1	1	1	1	1	1	1
1	1	1	1	1	1	1	39	39	39	39	39	39	39	39	39	39	39	39	39	39	39	1	1	1	1	39	39	39	39	39	39	39	39	39	1	1	1	1	1	1	1	1	1	1	1	1	1
1	1	1	1	1	1	1	1	1	1	1	1	1	1	1	1	1	1	1	1	39	39	1	1	1	1	39	39	39	39	39	1	1	1	1	1	1	1	1	1	1	1	1	1	1	1	1	1
1	1	1	1	1	1	1	1	1	1	1	1	1	1	1	1	1	1	1	1	1	1	1	1	1	1	1	1	1	1	1	1	1	1	1	1	1	1	1	1	1	1	1	1	1	1	1	1
1	1	1	1	1	1	1	1	1	1	1	1	1	1	1	1	1	1	1	1	1	1	1	1	1	1	1	1	1	1	1	1	1	1	1	1	1	1	1	1	1	1	1	1	1	1	1	1
468 12 23
469 42 23
470 40 7
471 26 12
21
