48 31
12 22
7
12
0 0
1	1	1	1	1	1	1	1	1	1	1	1	1	1	1	1	1	1	1	1	1	1	1	1	1	1	1	1	1	1	1	1	1	1	1	1	1	1	1	1	1	1	1	1	1	1	1	1
1	1	1	1	1	1	1	1	1	1	1	1	1	1	1	1	1	1	1	1	1	1	1	1	1	1	1	1	1	1	1	39	39	39	39	1	1	1	1	1	1	1	1	1	1	1	1	1
1	1	1	1	1	1	1	1	1	1	1	1	1	1	1	1	1	1	1	1	1	1	1	1	1	1	1	1	1	1	1	39	39	39	39	21	1	1	1	1	1	1	1	1	1	1	1	1
1	1	1	1	1	1	1	1	1	1	1	1	1	1	1	1	1	1	1	1	1	1	1	1	1	1	1	1	1	1	1	39	39	39	39	1	21	1	1	1	1	1	1	1	1	1	1	1
1	1	1	1	1	1	1	1	1	1	1	1	1	1	1	1	1	1	1	1	1	1	1	1	1	1	1	1	1	1	1	39	39	39	39	1	1	21	1	1	1	1	1	1	1	1	1	1
1	1	1	1	1	1	1	1	1	1	1	1	1	1	1	1	1	1	1	1	1	1	1	1	1	1	1	1	1	1	1	39	39	39	39	1	1	1	21	39	39	39	1	1	1	1	1	1
1	1	1	1	1	1	1	1	1	1	1	1	1	1	1	1	1	1	1	1	1	1	1	1	1	1	1	1	1	1	1	39	39	39	39	1	1	1	1	39	39	39	1	1	1	1	1	1
1	1	1	1	1	1	1	1	1	1	1	1	1	1	1	1	39	39	39	1	1	1	1	1	1	1	1	1	1	1	1	39	39	39	39	1	1	1	1	1	39	1	1	1	1	1	1	1
1	1	1	1	1	1	1	1	1	1	1	1	1	1	1	1	39	39	39	1	1	1	1	1	1	1	1	1	1	1	1	39	1	1	1	1	1	1	1	1	1	1	39	39	39	1	1	1
1	1	1	1	1	1	1	1	1	1	1	1	39	39	39	39	39	39	39	1	1	1	1	1	1	1	1	1	1	1	1	39	1	1	1	1	1	1	1	1	1	1	39	39	39	1	1	1
1	1	1	1	1	1	1	1	1	1	1	1	39	1	1	1	1	1	1	1	1	1	1	1	1	1	1	1	1	1	1	39	1	1	39	39	39	39	39	39	39	39	39	39	39	1	1	1
1	1	1	1	1	1	1	1	1	1	1	1	39	1	1	1	1	1	1	1	1	1	1	1	1	31	31	31	1	1	1	39	1	1	39	1	1	1	39	1	1	1	39	1	1	1	1	1
1	1	1	1	1	1	1	1	1	1	1	1	39	39	39	39	1	1	1	1	1	1	1	1	1	31	31	31	1	1	1	39	1	1	39	1	1	1	39	1	1	1	39	1	1	1	1	1
1	1	1	1	1	1	1	1	1	1	1	1	39	1	1	39	1	1	1	1	1	1	1	1	1	39	39	39	1	1	1	39	1	1	39	1	1	1	39	1	1	1	39	1	1	1	1	1
1	1	1	1	1	1	1	1	1	1	1	1	39	1	1	39	39	39	39	39	39	39	39	39	39	39	39	39	39	39	39	39	39	39	39	1	1	1	39	1	1	1	39	1	1	1	1	1
1	1	1	1	39	39	39	39	39	39	39	39	39	1	1	1	1	1	1	39	1	1	1	1	1	39	39	39	1	1	39	1	1	1	1	1	1	1	39	1	1	1	39	1	1	1	1	1
1	1	1	1	39	39	1	1	1	39	1	1	39	1	1	1	1	1	1	39	1	1	1	1	1	1	1	1	1	1	39	1	1	1	1	1	1	1	39	1	1	1	39	1	1	1	1	1
1	1	1	1	39	39	1	1	1	39	1	1	39	1	1	1	1	1	1	39	1	1	1	1	1	1	1	1	1	1	39	1	1	1	1	39	39	39	39	1	1	1	39	1	1	1	1	1
1	1	1	1	39	39	39	1	1	39	1	1	39	1	1	1	1	1	1	39	1	1	1	1	1	1	1	1	1	1	39	1	1	1	1	39	39	39	39	1	1	1	39	1	1	1	1	1
1	1	1	1	39	39	39	1	1	39	1	1	39	1	1	1	1	1	1	39	1	1	1	1	1	1	1	1	1	1	39	1	1	1	1	1	1	1	39	1	1	1	39	1	1	1	1	1
1	1	1	1	39	39	39	1	1	1	1	1	39	1	1	1	1	1	1	39	1	1	1	1	1	1	1	1	1	1	39	1	1	1	1	1	1	1	39	39	39	39	39	1	1	1	1	1
1	1	1	1	39	39	39	1	1	1	1	1	39	1	1	1	1	1	1	39	1	1	1	1	1	1	1	1	1	1	39	1	1	1	1	1	1	1	1	39	1	1	39	1	1	1	1	1
1	1	1	1	39	39	39	1	1	1	1	1	39	1	1	1	1	1	1	39	1	1	1	1	1	1	1	1	1	1	39	1	1	1	1	1	1	1	1	39	1	1	39	1	1	1	1	1
1	1	1	1	39	39	39	39	1	1	1	1	0	1	1	1	39	39	39	39	39	39	39	39	39	39	39	1	1	1	39	1	1	1	1	1	1	1	1	39	1	1	39	1	1	1	1	1
1	1	1	1	1	1	1	39	1	1	1	1	1	1	1	1	39	1	1	1	1	1	1	1	1	1	39	39	39	39	39	1	1	1	39	39	39	39	39	39	1	1	0	1	1	1	1	1
1	1	1	1	1	1	1	39	1	1	1	1	1	1	1	1	39	1	1	1	1	1	1	1	1	1	39	39	39	39	39	1	1	1	39	1	1	1	1	1	1	1	1	1	1	1	1	1
1	1	1	1	1	1	1	39	1	1	1	1	1	1	1	1	39	1	1	1	39	39	39	1	1	1	39	39	39	39	39	1	1	1	39	1	1	1	1	1	1	1	1	1	1	1	1	1
1	1	1	1	1	1	1	39	39	39	39	39	39	39	39	39	39	39	39	39	39	39	39	1	1	1	39	39	39	39	39	39	39	39	39	1	1	1	1	1	1	1	1	1	1	1	1	1
1	1	1	1	1	1	1	1	1	1	1	1	1	1	1	1	1	1	1	1	39	39	39	1	1	1	39	39	39	39	39	1	1	1	1	1	1	1	1	1	1	1	1	1	1	1	1	1
1	1	1	1	1	1	1	1	1	1	1	1	1	1	1	1	1	1	1	1	1	1	1	1	1	1	1	1	1	1	1	1	1	1	1	1	1	1	1	1	1	1	1	1	1	1	1	1
1	1	1	1	1	1	1	1	1	1	1	1	1	1	1	1	1	1	1	1	1	1	1	1	1	1	1	1	1	1	1	1	1	1	1	1	1	1	1	1	1	1	1	1	1	1	1	1
468 12 23
469 42 23
470 40 7
471 26 12
757 17 6
758 36 16
759 43 7
36 1120 32
36 1152 64
36 1184 96
36 1216 128
37 1120 64
37 1152 96
37 1184 128
37 1216 160
95 1120 96
95 1152 128
95 1184 160
95 1216 192
21
