25 33
19 26
2
22
0 0
1	1	1	1	1	1	1	1	1	1	1	1	1	1	1	1	1	1	1	1	1	1	1	1	1
1	1	1	1	1	1	1	1	1	1	1	1	1	1	1	1	1	1	1	1	1	1	1	1	1
1	1	1	1	1	1	1	1	1	1	1	1	1	1	1	1	1	1	1	1	1	1	1	1	1
1	1	1	30	30	30	30	30	30	30	30	30	30	30	30	30	30	30	30	30	30	30	1	1	1
1	1	1	30	31	31	31	31	31	31	31	31	31	31	31	31	31	31	31	31	31	30	1	1	1
1	1	1	30	31	31	31	31	31	31	31	31	31	31	31	31	31	31	31	31	31	30	1	1	1
1	1	1	30	31	31	31	31	31	31	31	31	31	31	31	31	31	31	31	31	31	30	1	1	1
1	1	1	30	31	31	31	31	31	31	31	31	31	31	31	31	31	31	31	31	31	30	1	1	1
1	1	1	30	31	31	31	31	31	31	31	31	31	31	31	31	31	31	31	31	31	30	1	1	1
1	1	1	30	31	31	31	31	31	31	31	31	31	31	31	31	31	31	31	31	31	30	1	1	1
1	1	1	30	31	31	31	31	31	31	31	31	31	31	31	31	31	31	31	31	31	30	1	1	1
1	1	1	30	31	31	31	31	31	31	31	39	39	39	39	39	39	39	39	39	39	30	1	1	1
1	1	1	30	31	31	31	31	31	31	20	39	39	39	39	39	39	39	39	39	39	30	1	1	1
1	1	1	30	31	31	31	31	31	20	20	39	39	39	39	39	39	39	39	39	39	30	1	1	1
1	1	1	30	31	31	31	31	20	20	30	30	30	30	30	30	30	30	39	39	39	30	1	1	1
1	1	1	30	39	39	39	20	20	30	30	30	31	31	31	31	31	30	39	39	39	30	1	1	1	
1	1	1	30	39	39	39	20	30	30	30	30	31	31	31	31	31	30	39	39	39	30	1	1	1	
1	1	1	30	39	39	39	30	30	30	30	30	31	31	31	31	31	30	39	39	39	30	1	1	1	
1	1	1	30	19	19	19	31	31	31	31	31	31	31	31	31	31	30	39	39	39	30	1	1	1	
1	1	1	30	19	19	19	31	31	31	31	31	31	31	31	31	31	30	39	39	39	30	1	1	1	
1	1	1	30	19	19	19	31	31	31	31	31	31	31	31	31	31	30	39	39	39	30	1	1	1	
1	1	1	30	19	19	19	31	39	39	39	39	39	39	39	39	39	30	39	39	39	30	1	1	1
1	1	1	30	19	19	19	31	39	39	39	39	39	39	39	39	39	30	39	39	39	30	1	1	1
1	1	1	30	19	19	19	31	39	39	39	39	39	39	39	39	39	30	39	39	39	30	1	1	1
1	1	1	30	39	39	39	39	39	39	39	39	39	39	39	39	39	30	39	39	39	30	1	1	1
1	1	1	30	39	39	39	39	39	39	39	39	39	39	39	39	39	30	39	39	39	30	1	1	1
1	1	1	30	39	39	39	39	39	39	39	39	39	39	39	39	39	30	39	39	39	30	1	1	1
1	1	1	30	39	39	39	39	39	39	39	39	39	39	39	39	39	30	1	39	1	1	1	1	1
1	1	1	30	39	39	39	39	39	39	39	39	39	39	39	39	39	30	1	1	1	1	1	1	1
1	1	1	30	39	39	39	39	39	39	39	39	39	39	39	39	39	30	1	1	1	1	1	1	1
1	1	1	1	1	1	1	1	1	1	1	1	1	1	1	1	1	1	1	1	1	1	1	1	1
1	1	1	1	1	1	1	1	1	1	1	1	1	1	1	1	1	1	1	1	1	1	1	1	1
1	1	1	1	1	1	1	1	1	1	1	1	1	1	1	1	1	1	1	1	1	1	1	1	1
460 19 27
461 12 20
32 224 448
32 256 416
32 288 384
32 320 352
33 224 480
33 256 448
33 288 416
33 320 384
33 224 512
33 256 480
33 288 448
33 320 416
34 224 544
34 256 512
34 288 480
34 320 448
35 256 544
35 288 512
35 320 480
35 288 544
35 320 512
35 320 544
20