25 33
5 26
2
22
0 0
1	1	1	1	1	1	1	1	1	1	1	1	1	1	1	1	1	1	1	1	1	1	1	1	1
1	1	1	1	1	1	1	1	1	1	1	1	1	1	1	1	1	1	1	1	1	1	1	1	1
1	1	1	1	1	1	1	1	1	1	1	1	1	1	1	1	1	1	1	1	1	1	1	1	1
1	1	1	30	30	30	30	30	30	30	30	30	30	30	30	30	30	30	30	30	30	30	1	1	1
1	1	1	30	31	31	31	31	31	31	31	31	31	31	31	31	31	31	31	31	31	30	1	1	1
1	1	1	30	31	31	31	31	31	31	31	31	31	31	31	31	31	31	31	31	31	30	1	1	1
1	1	1	30	31	31	31	31	31	31	31	31	31	31	31	31	31	31	31	31	31	30	1	1	1
1	1	1	30	31	31	31	31	31	31	31	31	31	31	31	31	31	31	31	31	31	30	1	1	1
1	1	1	30	31	31	31	31	31	31	31	31	31	31	31	31	31	31	31	31	31	30	1	1	1
1	1	1	30	31	31	31	31	31	31	31	31	31	31	31	31	31	31	31	31	31	30	1	1	1
1	1	1	30	31	31	31	31	31	31	31	31	31	31	31	31	31	31	31	31	31	30	1	1	1
1	1	1	30	39	39	39	39	39	39	39	39	39	39	31	31	31	31	31	31	31	30	1	1	1
1	1	1	30	39	39	39	39	39	39	39	39	39	39	21	31	31	31	31	31	31	30	1	1	1
1	1	1	30	39	39	39	39	39	39	39	39	39	39	21	21	31	31	31	31	31	30	1	1	1
1	1	1	30	39	39	39	30	30	30	30	30	30	30	30	21	21	31	31	31	31	30	1	1	1
1	1	1	30	39	39	39	30	31	31	31	31	31	30	30	30	21	21	39	39	39	30	1	1	1
1	1	1	30	39	39	39	30	31	31	31	31	31	30	30	30	30	21	39	39	39	30	1	1	1
1	1	1	30	39	39	39	30	31	31	31	31	31	30	30	30	30	30	39	39	39	30	1	1	1
1	1	1	30	39	39	39	30	31	31	31	31	31	31	31	31	31	31	19	19	19	30	1	1	1
1	1	1	30	39	39	39	30	31	31	31	31	31	31	31	31	31	31	19	19	19	30	1	1	1
1	1	1	30	39	39	39	30	31	31	31	31	31	31	31	31	31	31	19	19	19	30	1	1	1
1	1	1	30	39	39	39	30	39	39	39	39	39	39	39	39	39	31	19	19	19	30	1	1	1
1	1	1	30	39	39	39	30	39	39	39	39	39	39	39	39	39	31	19	19	19	30	1	1	1
1	1	1	30	39	39	39	30	39	39	39	39	39	39	39	39	39	31	19	19	19	30	1	1	1
1	1	1	30	39	39	39	30	39	39	39	39	39	39	39	39	39	39	39	39	39	30	1	1	1
1	1	1	30	39	39	39	30	39	39	39	39	39	39	39	39	39	39	39	39	39	30	1	1	1
1	1	1	30	39	39	39	30	39	39	39	39	39	39	39	39	39	39	39	39	39	30	1	1	1
1	1	1	1	1	39	1	30	39	39	39	39	39	39	39	39	39	39	39	39	39	30	1	1	1
1	1	1	1	1	1	1	30	39	39	39	39	39	39	39	39	39	39	39	39	39	30	1	1	1
1	1	1	1	1	1	1	30	39	39	39	39	39	39	39	39	39	39	39	39	39	30	1	1	1
1	1	1	1	1	1	1	1	1	1	1	1	1	1	1	1	1	1	1	1	1	1	1	1	1
1	1	1	1	1	1	1	1	1	1	1	1	1	1	1	1	1	1	1	1	1	1	1	1	1
1	1	1	1	1	1	1	1	1	1	1	1	1	1	1	1	1	1	1	1	1	1	1	1	1
462 5 27
463 12 20
36 448 352
36 480 384
36 512 416
36 544 448
37 448 384
37 480 416
37 512 448
37 544 480
37 448 416
37 480 448
37 512 480
37 544 512
38 448 448
38 480 480
38 512 512
38 544 544
39 448 480
39 480 512
39 512 544
39 448 512
39 480 544
39 448 544 
20