15 21
4 13
3
0
0 0
1	1	1	1	1	1	1	1	1	1	1	1	1	1	1
1	1	1	1	1	1	1	1	1	1	1	1	1	1	1
1	1	1	1	1	1	1	1	1	1	1	1	1	1	1
1	1	1	1	1	1	1	30	30	30	30	30	1	1	1
1	1	1	1	1	1	1	30	31	31	31	30	1	1	1
1	1	1	1	1	1	1	30	31	31	31	30	1	1	1
1	1	1	1	1	1	1	30	31	31	31	30	1	1	1
1	1	1	1	1	1	1	30	39	39	39	30	1	1	1
1	1	1	1	1	1	1	31	39	39	39	30	1	1	1
1	1	1	1	1	1	1	31	39	39	39	30	1	1	1
1	1	1	1	1	1	1	31	39	39	39	30	1	1	1
1	1	1	1	1	1	20	39	39	39	39	30	1	1	1
1	1	1	1	1	20	1	30	39	39	39	30	1	1	1
1	1	1	0	20	1	1	30	39	39	39	30	1	1	1
1	1	1	0	1	1	1	30	39	39	39	30	1	1	1
1	1	1	1	1	1	1	30	39	39	39	30	1	1	1
1	1	1	1	1	1	1	30	30	39	30	30	1	1	1
1	1	1	1	1	1	1	1	1	0	1	1	1	1	1
1	1	1	1	1	1	1	1	1	1	1	1	1	1	1
1	1	1	1	1	1	1	1	1	1	1	1	1	1	1
1	1	1	1	1	1	1	1	1	1	1	1	1	1	1
457 3 13
458 9 17
459 9 6
20