52 37
6 32
11
24
0 0
1	1	1	1	1	1	1	1	1	1	1	1	1	1	1	1	1	1	1	1	1	1	1	1	1	1	1	1	1	1	1	1	1	1	1	1	1	1	1	1	1	1	1	1	1	1	1	1	1	1	1	1
1	1	1	1	1	1	1	1	1	1	1	1	1	1	1	1	1	1	1	1	1	1	1	1	1	1	1	1	1	1	1	1	1	1	1	1	1	1	1	1	1	1	1	1	1	1	1	1	1	1	1	1
1	1	1	1	1	1	1	1	1	1	1	1	1	1	1	1	1	1	1	1	1	1	1	1	1	1	1	1	1	1	1	1	1	1	1	1	1	1	1	1	1	1	1	1	1	1	1	1	1	1	1	1
1	1	1	1	1	1	1	1	1	1	1	1	1	1	1	30	30	30	30	30	30	30	30	1	1	1	1	1	1	1	1	1	1	1	1	1	1	1	30	30	30	30	30	30	30	30	30	1	1	1	1	1
1	1	1	1	1	1	1	1	1	1	1	1	1	30	30	30	31	31	31	31	31	31	30	30	30	30	30	30	30	30	30	30	30	30	30	30	30	30	30	31	31	31	31	31	31	31	30	30	30	1	1	1
1	1	1	1	1	1	1	1	1	1	1	1	1	30	31	31	31	31	31	31	31	31	31	31	31	31	31	31	31	31	31	31	31	31	31	31	31	31	31	31	31	31	31	31	31	31	31	31	30	1	1	1
1	1	1	1	1	1	1	1	1	1	1	1	1	30	31	31	31	31	31	31	31	0	31	31	31	31	31	31	31	31	31	31	31	31	31	31	31	31	31	31	0	31	31	31	31	31	31	31	30	1	1	1
1	1	1	1	1	1	1	1	1	1	1	1	1	30	31	31	31	31	31	31	39	39	31	31	31	31	31	31	31	31	31	31	31	31	31	31	31	31	31	31	39	39	31	31	31	31	31	31	30	1	1	1
1	1	1	1	1	1	1	1	1	1	1	1	1	30	31	31	31	31	31	20	39	39	31	31	31	31	31	31	31	31	31	31	31	31	31	31	31	31	31	31	39	39	21	31	31	31	31	31	30	1	1	1
1	1	1	1	1	1	1	1	1	1	1	1	1	30	31	31	39	39	20	31	31	31	31	31	31	31	31	31	31	31	31	31	31	31	31	31	31	31	31	31	31	31	31	21	39	39	31	31	30	1	1	1
1	1	1	1	1	1	1	1	1	1	1	1	1	30	31	31	39	39	31	31	31	31	31	31	31	39	39	39	31	31	31	31	31	31	39	39	39	31	31	31	31	31	31	31	39	39	31	31	30	1	1	1
1	1	1	1	1	1	1	1	1	1	1	1	1	30	31	31	18	18	31	31	31	31	31	31	31	39	39	39	31	31	31	31	31	31	39	39	39	31	31	31	31	31	31	31	18	18	31	31	30	1	1	1
1	1	1	1	1	1	1	1	1	1	1	1	1	30	31	31	18	18	31	31	31	31	0	31	31	39	39	39	31	31	31	31	31	31	39	39	39	31	31	31	31	31	31	31	18	18	31	31	30	1	1	1
1	1	1	1	1	1	1	1	1	1	1	1	1	30	39	39	39	39	39	39	39	39	39	39	39	39	39	39	39	39	39	39	39	39	39	39	39	39	39	39	39	39	39	39	39	39	39	39	30	1	1	1
1	1	1	1	1	1	1	1	1	1	1	1	1	30	39	39	39	39	39	39	39	39	39	39	39	39	39	39	39	39	39	39	39	39	39	39	39	39	39	39	39	39	39	39	39	39	39	39	30	1	1	1
1	1	1	1	1	1	1	1	1	1	1	1	1	30	39	39	39	39	39	39	39	39	39	39	39	39	39	39	39	39	39	39	39	39	39	39	39	39	39	39	39	39	39	39	39	39	39	39	30	1	1	1
1	1	1	30	30	30	30	30	30	30	1	1	1	30	39	39	39	39	39	39	39	39	39	39	39	39	39	39	39	39	39	39	39	39	39	39	39	39	39	39	39	39	39	39	39	39	39	39	30	1	1	1
1	1	1	30	31	31	31	31	31	30	1	1	1	30	39	39	39	39	39	39	39	39	39	39	39	39	39	39	39	39	39	39	39	39	39	39	39	39	39	39	39	39	39	39	39	39	39	39	30	1	1	1
1	1	1	30	31	31	31	31	31	30	1	1	1	30	39	39	39	39	39	39	39	39	39	39	39	39	39	39	39	39	39	39	39	39	39	39	39	39	39	39	39	39	39	39	39	39	39	39	30	1	1	1
1	1	1	30	31	31	31	31	31	30	1	1	1	30	39	39	39	39	39	39	39	39	39	39	39	39	39	39	39	39	39	39	39	39	39	39	39	39	39	39	39	39	39	39	39	39	39	39	30	1	1	1
1	1	1	30	39	39	39	39	39	30	30	30	30	30	30	30	30	30	39	39	39	30	30	30	30	30	30	30	30	30	30	30	30	30	30	30	30	30	30	30	30	30	30	30	30	30	30	30	30	1	1	1
1	1	1	30	39	39	39	39	39	30	31	31	31	31	31	31	31	30	39	39	39	30	31	31	31	31	31	31	31	31	31	31	31	31	31	31	31	31	31	31	31	31	31	31	31	31	31	31	30	1	1	1
1	1	1	30	39	39	39	39	39	31	39	39	39	39	39	39	39	30	39	39	39	30	39	39	39	39	39	39	39	39	39	39	39	39	39	39	39	39	39	39	39	39	39	39	39	39	39	39	30	1	1	1
1	1	1	30	39	39	39	39	39	31	39	39	39	39	39	39	39	31	39	39	39	31	39	39	39	39	39	39	39	39	39	39	39	39	39	39	39	39	39	39	39	39	39	39	39	39	39	39	30	1	1	1
1	1	1	30	39	39	39	39	39	31	39	39	39	39	39	39	39	39	39	39	39	39	39	39	39	39	39	39	39	39	39	39	39	39	39	39	39	39	39	39	39	39	39	39	39	39	39	39	30	1	1	1
1	1	1	30	39	39	39	39	39	39	39	39	39	39	39	39	39	39	39	39	39	39	39	39	39	39	39	39	39	39	39	39	39	39	39	39	39	39	39	39	39	39	39	39	39	39	39	39	30	1	1	1
1	1	1	30	39	39	39	39	39	39	39	39	39	39	39	39	39	39	39	39	39	39	39	39	39	39	39	39	39	39	39	39	39	39	39	39	39	39	39	39	39	39	39	39	39	39	39	39	30	1	1	1
1	1	1	30	39	39	39	39	39	39	39	39	39	39	39	39	39	30	39	39	39	30	30	30	30	30	30	39	39	39	39	39	39	39	39	39	39	39	39	39	39	39	39	39	30	30	30	30	30	1	1	1
1	1	1	30	39	39	39	39	39	30	39	39	39	39	39	39	39	30	39	39	39	30	1	1	1	1	30	39	39	39	39	39	39	39	39	39	39	39	39	39	39	39	39	39	30	1	1	1	1	1	1	1
1	1	1	30	39	39	39	39	39	30	39	39	39	39	39	39	39	30	30	39	30	30	1	1	1	1	30	39	39	39	39	39	39	39	39	39	39	39	39	39	39	39	39	39	30	1	1	20	0	1	1	1
1	1	1	30	39	39	39	39	39	30	39	39	39	39	39	39	39	30	1	0	1	1	1	1	1	1	30	39	39	39	39	39	39	39	39	39	39	39	39	39	39	39	39	39	30	1	20	1	1	1	1	1
1	1	1	30	39	39	39	39	39	30	39	39	39	39	39	39	39	30	1	1	1	1	1	1	1	1	30	39	39	39	39	39	39	39	39	39	39	39	39	39	39	39	39	39	31	20	1	1	1	1	1	1
1	1	1	30	30	30	39	30	30	30	30	30	30	30	30	30	30	30	1	1	1	1	1	1	1	1	30	39	39	39	39	39	39	39	39	39	39	39	39	39	39	39	39	39	20	1	1	1	1	1	1	1
1	1	1	1	1	1	0	1	1	1	1	1	1	1	1	1	1	1	1	1	1	1	1	1	1	1	30	30	30	30	30	30	30	30	30	30	30	30	30	30	30	39	39	39	1	1	1	1	1	1	1	1
1	1	1	1	1	1	1	1	1	1	1	1	1	1	1	1	1	1	1	1	1	1	1	1	1	1	1	1	1	1	1	1	1	1	1	1	1	1	1	1	30	30	30	30	1	1	1	1	1	1	1	1
1	1	1	1	1	1	1	1	1	1	1	1	1	1	1	1	1	1	1	1	1	1	1	1	1	1	1	1	1	1	1	1	1	1	1	1	1	1	1	1	1	1	1	1	1	1	1	1	1	1	1	1
1	1	1	1	1	1	1	1	1	1	1	1	1	1	1	1	1	1	1	1	1	1	1	1	1	1	1	1	1	1	1	1	1	1	1	1	1	1	1	1	1	1	1	1	1	1	1	1	1	1	1	1
450 6 33
451 48 29
452 21 6
453 40 6
454 25 10
454 26 10
454 27 10
454 34 10
454 35 10
454 36 10
455 22 12
32 1504 896
32 1472 928
32 1440 960
32 1408 992
33 1504 928
33 1472 960
33 1440 992
33 1408 1024
93 1504 960
93 1472 992
93 1440 1024
93 1408 1056
32 576 256
32 608 224
33 576 288
33 608 256
93 576 320
93 608 288
36 1344 224
36 1376 256
37 1344 256
37 1376 288
95 1344 288
95 1376 320
18
