15 21
4 13
3
9
0 0
1	1	1	1	1	1	1	1	1	1	1	1	1	1	1
1	1	1	1	1	1	1	1	1	1	1	1	1	1	1
1	1	1	1	1	1	1	1	1	1	1	1	1	1	1
1	1	1	1	1	1	1	30	30	30	30	30	1	1	1
1	1	1	1	1	1	1	30	31	31	31	30	1	1	1
1	1	1	1	1	1	1	30	31	31	31	30	1	1	1
1	1	1	1	1	1	1	30	31	31	31	30	1	1	1
1	1	1	1	1	1	1	31	39	39	39	30	1	1	1
1	1	1	1	1	1	1	31	39	39	39	30	1	1	1
1	1	1	1	1	1	1	31	39	39	39	30	1	1	1
1	1	1	1	1	1	1	39	39	39	39	30	1	1	1
1	1	1	1	1	1	20	39	39	39	39	30	1	1	1
1	1	1	1	1	20	1	30	39	39	39	30	1	1	1
1	1	1	0	20	1	1	30	39	39	39	30	1	1	1
1	1	1	0	1	1	1	30	39	39	39	30	1	1	1
1	1	1	1	1	1	1	30	39	39	39	30	1	1	1
1	1	1	1	1	1	1	30	30	39	30	30	1	1	1
1	1	1	1	1	1	1	1	1	0	1	1	1	1	1
1	1	1	1	1	1	1	1	1	1	1	1	1	1	1
1	1	1	1	1	1	1	1	1	1	1	1	1	1	1
1	1	1	1	1	1	1	1	1	1	1	1	1	1	1
457 3 13
458 9 17
459 9 6
32 128 384
32 160 352
32 192 320
33 128 416
33 160 384
33 192 352
93 128 448
93 160 416
93 192 384
20