25 33
19 26
2
0
0 0
1	1	1	1	1	1	1	1	1	1	1	1	1	1	1	1	1	1	1	1	1	1	1	1	1
1	1	1	1	1	1	1	1	1	1	1	1	1	1	1	1	1	1	1	1	1	1	1	1	1
1	1	1	1	1	1	1	1	1	1	1	1	1	1	1	1	1	1	1	1	1	1	1	1	1
1	1	1	30	30	30	30	30	30	30	30	30	30	30	30	30	30	30	30	30	30	30	1	1	1
1	1	1	30	31	31	31	31	31	31	31	31	31	31	31	31	31	31	31	31	31	30	1	1	1
1	1	1	30	31	31	31	31	31	31	31	31	31	31	31	31	31	31	31	31	31	30	1	1	1
1	1	1	30	31	31	31	31	31	31	31	31	31	31	31	31	31	31	31	31	31	30	1	1	1
1	1	1	30	31	31	31	31	31	31	31	31	31	31	31	31	31	31	31	31	31	30	1	1	1
1	1	1	30	31	31	31	31	31	31	31	31	31	31	31	31	31	31	31	31	31	30	1	1	1
1	1	1	30	31	31	31	31	31	31	31	31	31	31	31	31	31	31	31	31	31	30	1	1	1
1	1	1	30	31	31	31	31	31	31	31	31	31	31	31	31	31	31	31	31	31	30	1	1	1
1	1	1	30	31	31	31	31	31	31	20	39	39	39	39	39	39	39	39	39	39	30	1	1	1
1	1	1	30	31	31	31	31	31	20	20	39	39	39	39	39	39	39	39	39	39	30	1	1	1
1	1	1	30	31	31	31	31	20	20	20	39	39	39	39	39	39	39	39	39	39	30	1	1	1
1	1	1	30	39	39	39	20	20	20	31	31	31	31	31	31	31	31	39	39	39	30	1	1	1
1	1	1	30	39	39	39	20	20	31	31	31	31	31	31	31	31	31	39	39	39	30	1	1	1	
1	1	1	30	39	39	39	20	31	31	31	31	31	31	31	31	31	31	39	39	39	30	1	1	1	
1	1	1	30	19	19	19	31	31	31	31	31	31	31	31	31	31	31	39	39	39	30	1	1	1	
1	1	1	30	19	19	19	31	31	31	31	31	31	31	31	31	31	31	39	39	39	30	1	1	1	
1	1	1	30	19	19	19	31	31	31	31	31	31	31	31	31	31	31	39	39	39	30	1	1	1	
1	1	1	30	19	19	19	31	31	31	31	31	31	31	31	31	31	31	39	39	39	30	1	1	1	
1	1	1	30	19	19	19	31	31	31	39	39	39	39	39	31	31	31	39	39	39	30	1	1	1
1	1	1	30	19	19	19	31	31	39	39	39	39	39	39	31	31	31	39	39	39	30	1	1	1
1	1	1	30	19	19	19	31	39	39	39	39	39	39	39	31	31	31	39	39	39	30	1	1	1
1	1	1	30	39	39	39	39	39	39	39	39	39	39	39	31	31	31	39	39	39	30	1	1	1
1	1	1	30	39	39	39	39	39	39	39	39	39	39	39	31	31	31	39	39	39	30	1	1	1
1	1	1	30	39	39	39	39	39	39	39	39	39	39	39	31	31	31	39	39	39	30	1	1	1
1	1	1	30	39	39	39	39	39	39	39	39	39	39	39	31	31	31	1	39	1	1	1	1	1
1	1	1	30	39	39	39	39	39	39	39	39	39	39	39	31	31	31	1	1	1	1	1	1	1
1	1	1	30	39	39	39	39	39	39	39	39	39	39	39	31	31	31	1	1	1	1	1	1	1
1	1	1	1	1	1	1	1	1	1	1	1	1	1	1	1	1	1	1	1	1	1	1	1	1
1	1	1	1	1	1	1	1	1	1	1	1	1	1	1	1	1	1	1	1	1	1	1	1	1
1	1	1	1	1	1	1	1	1	1	1	1	1	1	1	1	1	1	1	1	1	1	1	1	1
460 19 27
461 12 20
20