20 24
4 12
8
0
0 0
1	1	1	1	1	1	1	1	1	1	1	1	1	1	1	1	1	1	1	1
1	1	1	1	1	1	1	1	1	1	1	1	1	1	1	1	1	1	1	1
1	1	1	1	1	1	1	1	1	1	1	1	1	1	1	1	1	1	1	1
1	1	1	1	16	16	16	16	16	16	1	1	1	1	1	1	1	1	1	1
1	1	1	1	16	17	17	17	17	16	1	1	1	1	1	1	1	1	1	1
1	1	1	1	16	17	17	17	17	16	1	1	1	1	1	1	1	1	1	1
1	1	1	1	16	17	17	17	17	16	1	1	1	1	1	1	1	1	1	1
1	1	1	1	16	27	27	27	27	16	1	1	1	1	1	1	1	1	1	1
1	1	1	1	16	27	27	27	27	16	1	1	1	1	1	1	1	1	1	1
1	1	1	1	17	27	27	27	27	16	1	1	1	1	1	1	1	1	1	1
1	1	1	1	17	27	27	27	27	16	16	16	0	16	16	16	16	1	1	1
1	1	1	1	17	27	27	27	27	17	17	17	18	17	17	17	16	1	1	1
1	1	1	0	27	27	27	27	27	17	17	17	18	17	17	17	16	1	1	1
1	1	1	1	16	27	27	27	27	17	17	17	18	17	17	17	16	1	1	1
1	1	1	1	16	27	27	27	27	27	27	27	27	27	27	27	16	1	1	1
1	1	1	1	16	27	27	27	27	27	27	27	27	27	27	27	16	1	1	1
1	1	1	1	16	27	27	27	27	27	27	27	27	27	27	27	16	1	1	1
1	1	1	1	16	27	27	27	27	27	27	27	27	27	27	27	16	1	1	1
1	1	1	1	16	27	27	27	27	27	27	27	27	27	27	27	16	1	1	1
1	1	1	1	16	27	27	27	27	27	27	27	27	27	27	27	16	1	1	1
1	1	1	1	16	16	27	16	27	16	27	16	27	16	27	16	16	1	1	1
1	1	1	1	1	1	0	1	0	1	0	1	0	1	0	1	1	1	1	1
1	1	1	1	1	1	1	1	1	1	1	1	1	1	1	1	1	1	1	1
1	1	1	1	1	1	1	1	1	1	1	1	1	1	1	1	1	1	1	1
140 3 12
141 12 10
142 6 21
142 8 21
142 10 21
142 12 21
142 14 21
222 8 13