23 30
11 23
12
0
0 0
2   2   2   2   2   2   2   2   2   2   2   2   2   2   2   2   2   2   2   2   2   2   2
2   181 188 188 188 188 183 2   2   2   2   2   2   2   2   2   181 188 188 188 188 183 2   
2   186 170 170 170 170 184 2   2   2   2   2   2   2   2   2   186 170 170 170 170 184 2
2   170 176 176 176 176 184 2   2   2   2   2   2   2   2   2   186 176 176 176 176 170 2
2   176 191 191 191 191 184 2   2   2   2   2   2   2   2   2   186 191 191 191 191 176 2
1   191 191 191 191 191 184 2   2   2   2   2   2   2   2   2   186 191 191 191 191 191 1
2   186 191 191 191 191 184 2   2   2   2   2   2   2   2   2   186 191 191 191 191 184 2
2   170 191 191 191 191 184 2   2   2   2   2   2   2   2   2   186 191 191 191 191 170 2
2   176 191 191 191 191 184 2   2   2   2   2   2   2   2   2   186 191 191 191 191 176 2
1   191 191 191 191 191 184 2   2   2   2   2   2   2   2   2   186 191 191 191 191 191 1
2   186 191 191 191 191 184 2   2   2   2   2   2   2   2   2   186 191 191 191 191 184 2
2   170 191 191 191 191 184 2   2   2   2   2   2   2   2   2   186 191 191 191 191 170 2
2   176 191 191 191 191 184 2   2   2   2   2   2   2   2   2   186 191 191 191 191 176 2
1   191 191 191 191 191 184 2   2   2   2   2   2   2   2   2   186 191 191 191 191 191 1
2   186 191 191 191 191 184 2   2   2   181 188 183 2   2   2   186 191 191 191 191 184 2
2   170 191 191 191 191 188 188 188 188 189 1   187 188 188 188 188 191 191 191 191 170 2
2   176 191 191 191 191 170 170 170 170 170 191 170 170 170 170 170 191 191 191 191 176 2
1   191 191 191 191 191 176 176 176 176 176 191 176 176 176 176 176 191 191 191 191 191 1
2   186 191 191 191 191 191 191 191 191 191 191 191 191 191 191 191 191 191 191 191 184 2
2   170 191 191 191 191 191 191 191 191 191 191 191 191 191 191 191 191 191 191 191 170 2
2   176 191 191 191 191 191 191 191 191 191 191 191 191 191 191 191 191 191 191 191 176 2
2   191 191 191 191 191 191 191 191 191 191 191 191 191 191 191 191 191 191 191 191 191 1
2   186 191 191 191 191 191 191 191 191 191 191 191 191 191 191 191 191 191 191 191 184 2
2   186 191 191 191 191 191 191 191 191 191 191 191 191 191 191 191 191 191 191 191 184 2
2   187 188 188 188 188 188 188 188 188 183 191 181 188 188 188 188 188 188 188 188 189 2
2   2   2   2   2   2   2   2   2   2   186 191 184 2   2   2   2   2   2   2   2   2   2
2   2   2   2   2   2   2   2   2   2   186 191 184 2   2   2   2   2   2   2   2   2   2
2   2   2   2   2   2   2   2   2   2   186 191 184 2   2   2   2   2   2   2   2   2   2
2   2   2   2   2   2   2   2   2   2   186 191 184 2   2   2   2   2   2   2   2   2   2
2   2   2   2   2   2   2   2   2   2   2   1   2   2   2   2   2   2   2   2   2   2   2
166 11 29
167 11 15
168 0 5
168 0 9
168 0 13
168 0 17
168 0 21
168 22 5
168 22 9
168 22 13
168 22 17
168 22 21