20 16
4 9
2
0
1 2
1	1	1	1	1	1	1	1	1	1	1	1	1	1	1	1	1	1	1	1
1	1	1	1	1	1	1	1	1	1	1	1	1	1	1	1	1	1	1	1
1	1	1	1	1	1	1	1	1	1	1	1	1	1	1	1	1	1	1	1
1	1	1	1	1	1	1	1	1	1	1	1	16	16	16	1	1	1	1	1
1	1	1	1	1	1	1	1	1	1	1	16	16	17	16	16	1	1	1	1
1	1	1	1	16	16	16	16	16	16	16	16	17	17	17	16	16	1	1	1
1	1	1	1	17	17	17	17	17	17	17	17	17	17	17	17	16	1	1	1
1	1	1	1	17	17	17	17	17	17	17	17	17	27	17	17	16	1	1	1
1	1	1	1	17	17	17	17	17	17	17	17	27	27	27	17	16	1	1	1
1	1	1	0	27	27	27	27	27	27	27	27	27	27	27	27	16	1	1	1
1	1	1	1	16	16	16	16	16	16	16	16	27	27	27	16	16	1	1	1
1	1	1	1	1	1	1	1	1	1	1	16	16	27	16	16	1	1	1	1
1	1	1	1	1	1	1	1	1	1	1	1	16	16	16	1	1	1	1	1
1	1	1	1	1	1	1	1	1	1	1	1	1	1	1	1	1	1	1	1
1	1	1	1	1	1	1	1	1	1	1	1	1	1	1	1	1	1	1	1
1	1	1	1	1	1	1	1	1	1	1	1	1	1	1	1	1	1	1	1
167 3 9
168 13 7
4 10
14 10
2