23 10
11 23
3
0
0 0
2   2   2   2   2   2   2   2   2   2   2   2   2   2   2   2   2   2   2   2   2   2   2
2   181 188 188 188 188 188 188 188 188 188 188 188 188 188 188 188 188 188 188 188 183 2
2   186 170 1   170 170 1   170 170 1   170 170 1   170 170 1   170 170 1   170 170 184 2
2   186 176 191 176 176 191 176 176 191 176 176 191 176 176 191 176 176 191 176 176 184 2
2   186 191 191 191 191 191 191 191 191 191 191 191 191 191 191 191 191 191 191 191 184 2
2   186 191 191 191 191 191 191 191 191 191 191 191 191 191 191 191 191 191 191 191 186 2
2   186 191 191 191 191 191 191 191 191 191 191 191 191 191 191 191 191 191 191 191 184 2
2   186 191 191 191 191 191 191 191 191 191 191 191 191 191 191 191 191 191 191 191 184 2
2   187 188 191 188 188 188 188 188 188 188 188 188 188 188 188 188 188 191 188 188 189 2
2   2   2   1   2   2   2   2   2   2   2   2   2   2   2   2   2   2   2   2   2   2   2
171 3 9
172 18 2
173 15 2
