15 25
15 23
4
0
0 0
2   2   2   2   2   2   2   2   2   2   2   2   2   2   2
2   2   2   2   2   2   2   2   2   181 188 188 188 188 2
2   2   2   2   2   2   2   2   2   186 170 170 170 170 2
2   2   2   2   2   2   2   2   2   186 176 176 176 176 2
2   2   2   2   2   2   2   2   2   186 191 191 191 191 1
2   2   2   2   2   2   2   2   2   186 191 191 191 184 2
2   2   2   181 188 188 188 183 2   186 191 191 191 184 2
2   2   181 189 170 170 170 187 183 186 191 191 191 184 2
2   181 189 170 176 1   176 170 187 188 191 191 191 184 2
2   186 170 176 191 191 191 176 170 170 191 191 191 184 2
2   186 176 191 191 182 191 191 176 176 191 191 191 184 2
2   186 191 191 181 185 183 191 191 191 191 191 191 184 2
2   186 191 188 185 185 185 188 188 188 188 188 188 186 2
2   186 191 170 187 188 189 170 170 170 170 170 170 184 2
2   186 191 176 170 170 170 176 176 176 176 176 176 184 2
2   186 191 191 176 1   176 191 191 191 191 191 191 184 2
2   187 183 191 191 191 191 191 181 183 191 191 191 184 2
2   2   187 183 191 191 191 181 189 186 191 191 191 184 2
2   2   2   187 188 188 188 189 2   186 191 191 191 184 2
2   2   2   2   2   2   2   2   2   186 191 191 191 184 2
2   2   2   2   2   2   2   2   2   186 191 191 191 170 2
2   2   2   2   2   2   2   2   2   186 191 191 191 176 2
2   2   2   2   2   2   2   2   2   186 191 191 191 191 1
2   2   2   2   2   2   2   2   2   187 188 188 188 189 2
2   2   2   2   2   2   2   2   2   2   2   2   2   2   2
192 14 4
193 14 22
194 5 8
195 5 15