37 32
18 27
2
12
0 0
1	1	1	1	1	1	1	1	1	1	1	1	1	1	1	1	1	1	1	1	1	1	1	1	1	1	1	1	1	1	1	1	1	1	1	1	1	
1	1	1	1	1	1	1	1	1	1	1	1	1	1	1	1	1	1	1	1	1	1	1	1	1	1	1	1	1	1	1	1	1	1	1	1	1	
1	1	1	1	1	1	1	1	1	1	1	1	1	1	1	1	1	1	1	1	1	1	1	1	1	1	1	1	1	1	1	1	1	1	1	1	1	
1	1	1	1	1	1	1	1	1	1	1	1	1	1	1	1	1	1	1	16	16	16	16	16	16	16	16	16	16	16	1	1	1	1	1	1	1
1	1	1	1	1	1	1	1	1	1	1	1	1	1	1	1	1	1	1	16	16	16	16	16	16	16	16	16	16	16	1	1	1	1	1	1	1
1	1	1	1	1	1	1	1	1	1	1	1	1	1	1	1	1	1	1	16	16	16	16	16	16	16	16	16	16	16	1	1	1	1	1	1	1
1	1	1	1	1	1	1	1	1	1	1	1	1	1	1	1	1	1	1	16	16	16	16	16	16	16	16	16	16	16	1	1	1	1	1	1	1
1	1	1	1	1	1	1	1	1	1	1	1	1	1	1	1	1	1	1	16	16	16	16	16	16	16	16	16	16	16	1	1	1	1	1	1	1
1	1	1	1	1	1	1	1	1	1	1	1	1	1	1	1	1	1	1	16	16	16	16	16	16	16	16	16	16	16	1	1	1	1	1	1	1
1	1	1	1	1	1	1	1	1	1	1	1	1	1	1	1	1	1	1	17	17	17	17	17	17	17	17	17	17	17	1	1	1	1	1	1	1
1	1	1	1	1	1	1	1	1	1	1	1	1	1	1	1	1	1	1	17	17	17	17	17	17	17	17	17	17	17	1	1	1	1	1	1	1
1	1	1	1	1	1	1	2	2	2	2	2	2	2	2	2	2	2	2	17	17	17	17	17	17	17	17	17	17	17	1	1	1	1	1	1	1
1	1	1	1	1	1	20	2	2	2	2	2	2	2	2	2	2	2	2	17	17	17	17	17	17	17	17	17	17	17	1	1	1	1	1	1	1
1	1	1	1	1	20	1	16	2	2	2	2	2	2	2	2	2	2	2	17	17	17	17	17	17	17	17	17	17	17	1	1	1	1	1	1	1
1	1	1	0	20	1	1	16	16	2	2	2	2	2	2	2	2	2	2	17	17	17	17	17	17	17	17	17	17	17	1	1	1	1	1	1	1
1	1	1	0	1	1	1	1	16	2	2	2	2	2	2	2	2	2	2	17	17	17	17	17	17	17	17	17	17	17	1	1	1	1	1	1	1
1	1	1	1	1	1	1	1	16	2	2	2	2	2	2	2	2	2	2	17	17	17	17	17	17	17	17	17	17	17	1	1	1	1	1	1	1
1	1	1	1	1	1	1	1	16	2	2	2	2	2	2	2	2	2	2	17	17	17	17	17	17	17	17	17	17	17	1	1	1	1	1	1	1
1	1	1	1	1	1	1	1	16	2	2	2	2	2	2	2	2	2	2	17	17	17	17	17	17	17	17	17	17	17	1	1	1	1	1	1	1
1	1	1	1	1	1	1	1	16	2	2	2	2	2	2	2	2	2	2	17	17	17	0	17	17	17	17	17	17	17	1	1	1	1	1	1	1
1	1	1	1	1	1	1	1	16	16	16	16	16	16	2	2	2	2	2	2	2	2	2	2	2	2	2	17	17	17	1	1	1	1	1	1	1
1	1	1	1	1	1	1	1	1	1	1	1	1	16	2	2	2	2	2	2	2	2	2	2	2	2	2	17	17	17	1	1	1	1	1	1	1
1	1	1	1	1	1	1	1	1	1	1	1	1	16	2	2	2	2	2	2	2	2	2	2	2	2	2	17	17	17	1	1	1	1	1	1	1
1	1	1	1	1	1	1	1	1	1	1	1	1	16	2	2	2	2	2	2	2	2	2	2	2	2	2	17	17	17	1	1	1	1	1	1	1
1	1	1	1	1	1	1	1	1	1	1	1	1	16	2	2	2	2	2	2	2	2	2	2	2	2	2	17	17	17	1	1	1	1	1	1	1
1	1	1	1	1	1	1	1	1	1	1	1	1	16	2	2	2	2	2	2	2	2	2	2	2	2	2	17	17	17	1	1	1	1	1	1	1
1	1	1	1	1	1	1	1	1	1	1	1	1	16	2	2	2	2	2	2	2	2	2	2	2	2	2	17	17	17	1	1	1	1	1	1	1
1	1	1	1	1	1	1	1	1	1	1	1	1	16	16	16	16	16	2	16	16	16	16	16	16	16	16	16	17	17	1	1	1	1	1	1	1
1	1	1	1	1	1	1	1	1	1	1	1	1	1	1	1	1	1	0	1	1	1	1	1	1	1	1	1	1	1	1	1	1	1	1	1	1	
1	1	1	1	1	1	1	1	1	1	1	1	1	1	1	1	1	1	1	1	1	1	1	1	1	1	1	1	1	1	1	1	1	1	1	1	1	
1	1	1	1	1	1	1	1	1	1	1	1	1	1	1	1	1	1	1	1	1	1	1	1	1	1	1	1	1	1	1	1	1	1	1	1	1	
1	1	1	1	1	1	1	1	1	1	1	1	1	1	1	1	1	1	1	1	1	1	1	1	1	1	1	1	1	1	1	1	1	1	1	1	1	
193 18 28
194 3 15
32 128 416
32 160 384
32 192 352
33 128 448
33 160 416
33 192 384
34 128 480
34 160 448
34 192 416
35 160 480
35 192 480
35 192 448
