32 45
12 15
7
8
1.2 3
1	1	1	1	1	1	1	1	1	1	1	1	1	1	1	1	1	1	1	1	1	1	1	1	1	1	1	1	1	1	1	1
1	1	1	1	1	1	1	1	1	1	1	1	1	1	1	1	1	1	1	1	1	1	1	1	1	1	1	1	1	1	1	1
1	1	1	1	1	1	1	1	1	1	1	1	1	1	1	1	1	1	1	1	1	1	1	1	1	1	1	1	1	1	1	1
1	1	1	1	1	1	1	1	1	1	1	1	1	1	1	1	1	16	16	16	16	16	16	16	16	16	1	1	1	1	1	1
1	1	1	1	1	1	1	1	1	1	1	1	1	1	1	1	1	16	17	17	17	17	17	17	17	17	1	1	1	1	1	1
1	1	1	1	1	1	1	1	1	1	1	1	1	1	1	1	1	16	17	17	17	17	17	17	17	17	1	1	1	1	1	1
1	1	1	1	1	1	1	1	1	1	1	1	1	1	1	1	1	16	17	17	17	17	17	17	17	17	1	1	1	1	1	1
1	1	1	1	1	1	1	1	1	1	1	1	1	1	1	1	1	16	27	27	27	27	27	27	27	27	1	1	1	1	1	1
1	1	1	1	1	1	1	1	1	1	1	1	1	1	1	1	1	16	27	27	27	27	27	27	27	27	21	1	1	1	1	1
1	1	1	1	1	1	1	1	1	1	1	1	1	1	1	1	1	16	27	27	27	27	27	27	27	27	21	21	0	1	1	1
1	1	1	1	16	16	16	16	16	16	16	16	16	16	16	16	16	16	27	27	27	27	27	27	27	16	1	21	0	1	1	1
1	1	1	1	16	17	17	17	17	17	17	17	17	17	17	17	17	17	27	27	27	27	27	27	27	16	1	1	1	1	1	1
1	1	1	1	16	17	17	17	17	17	17	17	17	17	17	17	17	17	27	27	27	27	27	27	27	16	1	1	1	1	1	1
1	1	1	1	16	17	17	17	17	17	17	17	17	17	17	17	17	17	27	27	27	27	27	27	27	16	1	1	1	1	1	1
1	1	1	1	16	27	27	27	27	27	27	27	27	27	27	27	27	27	27	27	27	27	27	27	27	16	1	1	1	1	1	1
1	1	1	1	16	27	27	27	27	27	27	27	27	27	27	27	27	27	27	27	27	27	27	27	27	16	1	1	1	1	1	1
1	1	1	1	16	27	27	27	27	27	27	27	27	27	27	27	27	27	27	27	27	27	16	16	16	16	1	1	1	1	1	1
1	1	1	1	16	27	27	27	27	27	27	27	27	27	27	27	27	27	27	27	27	27	16	1	1	1	1	1	1	1	1	1
1	1	1	1	16	27	27	27	27	27	27	27	27	27	27	27	27	27	27	27	27	27	16	1	1	1	1	1	1	1	1	1
1	1	1	1	16	16	27	16	16	16	16	16	27	27	27	27	27	27	27	27	27	27	16	1	1	1	1	1	1	1	1	1
1	1	1	1	1	1	0	1	1	1	1	16	27	27	27	27	27	27	27	27	27	27	16	1	1	1	1	1	1	1	1	1
1	1	1	1	1	1	1	1	1	1	1	16	27	27	27	27	27	27	27	27	27	27	16	1	1	1	1	1	1	1	1	1
1	1	1	1	1	1	1	1	1	1	1	16	27	27	27	27	27	27	27	27	27	27	16	1	1	1	1	1	1	1	1	1
1	1	1	1	1	1	1	1	1	1	1	16	16	16	16	16	16	27	27	27	27	27	16	1	1	1	1	1	1	1	1	1
1	1	1	1	1	1	1	1	1	1	1	1	1	1	1	1	16	27	27	27	27	27	16	1	1	1	1	1	1	1	1	1
1	1	1	1	1	1	1	1	1	1	1	1	1	1	1	1	16	27	27	27	27	27	16	1	1	1	1	1	1	1	1	1
1	1	1	1	1	1	1	1	1	1	1	1	1	1	1	1	16	27	27	27	27	27	16	1	1	1	1	1	1	1	1	1
1	1	1	1	1	1	1	1	1	1	1	1	1	1	1	1	16	27	27	27	27	27	16	1	1	1	1	1	1	1	1	1
1	1	1	1	1	1	1	1	1	1	1	1	1	1	1	1	16	27	27	27	27	27	16	1	1	1	1	1	1	1	1	1
1	1	1	1	1	1	1	1	1	1	16	16	16	16	16	16	16	27	27	27	27	27	16	16	16	1	1	1	1	1	1	1
1	1	1	1	1	1	1	1	1	1	16	17	17	17	17	17	17	27	27	27	27	27	17	17	16	1	1	1	1	1	1	1
1	1	1	1	1	1	1	1	1	1	16	17	17	17	17	17	17	27	27	27	27	27	17	17	16	1	1	1	1	1	1	1
1	1	1	1	1	1	1	1	1	1	16	17	17	17	17	17	17	27	27	27	27	27	17	17	16	1	1	1	1	1	1	1
1	1	1	1	1	1	1	1	1	1	16	27	27	27	27	27	27	27	27	27	27	27	27	27	16	1	1	1	1	1	1	1
1	1	1	1	1	1	1	1	1	1	16	27	27	27	27	27	27	27	27	27	27	27	27	27	16	1	1	1	1	1	1	1
1	1	1	1	1	1	1	1	1	1	16	27	27	27	27	27	27	27	27	27	27	27	27	27	16	1	1	1	1	1	1	1
1	1	1	1	1	1	1	1	1	1	16	27	27	27	27	27	27	27	27	27	27	27	27	27	16	1	1	1	1	1	1	1
1	1	1	1	1	1	1	1	1	1	16	27	27	27	27	27	27	27	27	27	27	27	27	27	16	1	1	1	1	1	1	1
1	1	1	1	1	1	1	1	1	1	16	27	27	27	16	16	16	16	16	16	16	16	16	16	16	1	1	1	1	1	1	1
1	1	1	1	1	1	1	1	1	1	16	27	27	27	16	1	1	1	1	1	1	1	1	1	1	1	1	1	1	1	1	1
1	1	1	1	1	1	1	1	1	1	16	27	27	27	16	1	1	1	1	1	1	1	1	1	1	1	1	1	1	1	1	1
1	1	1	1	1	1	1	1	1	1	16	16	16	16	16	1	1	1	1	1	1	1	1	1	1	1	1	1	1	1	1	1
1	1	1	1	1	1	1	1	1	1	1	1	1	1	1	1	1	1	1	1	1	1	1	1	1	1	1	1	1	1	1	1
1	1	1	1	1	1	1	1	1	1	1	1	1	1	1	1	1	1	1	1	1	1	1	1	1	1	1	1	1	1	1	1
1	1	1	1	1	1	1	1	1	1	1	1	1	1	1	1	1	1	1	1	1	1	1	1	1	1	1	1	1	1	1	1
197 28 10
197 28 9
198 6 20
199 20 6
252 18 7
253 12 33
258 12 40
36 832 224
36 864 256
37 832 256
37 864 288
37 832 288
37 864 320
94 832 320
94 864 352
4 5
18 5
21 20
3