15 12
12 15
2
0 0
2   2   2   2   2   2   2   2   2   2   2   2   2   2   2
2   2   2   181 188 183 2   2   2   2   2   2   2   2   2
2   2   181 189 170 187 183 2   2   2   2   2   2   2   2
2   181 189 170 176 170 188 188 188 188 188 188 188 183 2
2   186 170 176 191 176 170 170 170 170 170 170 170 170 2
2   186 176 191 191 191 176 176 176 176 176 176 176 176 2
2   186 191 191 191 191 191 191 191 191 191 191 191 191 1
2   186 183 191 191 191 181 188 188 188 188 188 188 189 2
2   2   187 183 193 181 189 2   2   2   2   2   2   2   2
2   2   2   186 193 184 2   2   2   2   2   2   2   2   2 
2   2   2   186 2   184 2   2   2   2   2   2   2   2   2
2   2   2   2   2   2   2   2   2   2   2   2   2   2   2
197 14 6
198 4 8