31 32
12 15
0
0 0
2   2   2   2   2   2   2   2   2   2   2   2   2   2   2   2   2   2   2   2   2   2   2   2   2   
2   2   2   2   2   2   2   2   188 188 188 188 188 188 188 188 189 2   2   2   2   2   2   2   2   
2   2   2   2   2   2   2   2   170 170 170 170 170 170 170 170 188 188 2   2   2   2   2   2   2  
2   2   2   2   2   2   2   2   176 176 176 176 176 176 176 176 170 170 2   2   2   2   2   2   2   
2   2   2   2   2   2   2   2   194 194 194 194 194 194 194 194 176 170 2   2   2   2   2   2   2   
2   2   2   2   2   2   2   2   194 194 194 194 194 194 194 194 192 176 2   2   2   2   2   2   2   
2   2   2   2   2   2   2   2   194 194 194 194 194 194 194 194 192 192 2   2   2   2   2   2   2  
2   2   2   2   2   2   2   2   194 194 194 194 194 194 194 194 192 192 1   2   2   2   2   2   2  
2   2   2   2   2   2   2   2   194 194 194 194 194 194 194 194 189 192 1   2   2   2   2   2   2   
2   2   2   2   2   2   2   2   194 194 194 194 194 194 187 188 186 170 1   2   2   2   2   2   2   
2   2   2   2   2   2   2   2   194 194 194 194 194 194 184 185 186 170 2   2   2   2   2   2   2   
2   2   2   2   2   2   2   2   194 194 194 194 194 194 184 185 186 176 2   2   2   2   2   2   2   
2   2   2   2   2   2   2   2   194 194 194 194 194 194 184 185 186 2   2   2   2   2   2   2   2   
2   2   2   2   2   2   2   2   194 194 194 194 194 194 187 188 186 2   2   2   2   2   2   2   2   
2   2   2   2   2   2   2   2   194 194 194 194 194 194 194 194 186 2   2   2   2   2   2   2   2   
2   2   2   2   2   2   2   2   194 194 194 194 194 194 194 194 186 2   2   2   2   2   2   2   2  
2   2   2   2   2   2   2   2   194 194 194 194 194 194 194 194 186 2   2   2   2   2   2   2   2   
2   2   2   2   2   2   2   2   194 194 194 194 194 194 194 194 186 2   2   2   2   2   2   2   2   
2   2   2   2   2   2   2   2   194 194 194 194 194 194 194 194 186 2   2   2   2   2   2   2   2   
2   2   2   2   2   2   2   2   194 194 194 194 194 194 194 194 186 2   2   2   2   2   2   2   2   
2   2   2   2   2   2   2   2   194 194 194 194 194 194 194 194 186 2   2   2   2   2   2   2   2   
2   2   2   2   2   2   2   2   194 194 194 194 194 194 194 194 186 2   2   2   2   2   2   2   2   
2   2   2   2   2   2   2   2   194 194 194 194 194 194 194 194 186 2   2   2   2   2   2   2   2   
2   2   2   2   2   2   2   2   188 188 188 188 188 188 188 188 189 2   2   2   2   2   2   2   2   
2   2   2   2   2   2   2   2   2   2   2   2   2   2   2   2   2   2   2   2   2   2   2   2   2  
2   2   2   2   2   2   2   2   2   2   2   2   2   2   2   2   2   2   2   2   2   2   2   2   2   
2   2   2   2   2   2   2   2   2   2   2   2   2   2   2   2   2   2   2   2   2   2   2   2   2    
2   2   2   2   2   2   2   2   2   2   2   2   2   2   2   2   2   2   2   2   2   2   2   2   2   
