28 25
11 23
14
0 0
2   2   2   2   2   2   2   2   2   2   2   2   2   2   2   2   2   2   2   2   2   2   2   2   2   2   2   2
2   181 188 188 188 188 183 2   2   2   2   2   2   2   2   2   2   2   2   2   2   181 188 188 188 188 183 2
2   186 170 170 170 170 184 2   2   2   2   2   2   2   2   2   2   2   2   2   2   186 170 170 170 170 184 2
2   186 176 176 176 176 184 2   2   2   2   2   2   2   2   2   2   2   2   2   2   186 176 176 176 176 184 2
2   186 191 191 191 191 184 2   2   2   2   2   2   2   2   2   2   2   2   2   2   186 191 191 191 191 184 2
1   191 191 191 191 191 184 2   2   2   2   2   2   2   2   2   2   2   2   2   2   186 191 191 191 191 191 1
2   186 191 191 191 191 184 2   2   2   2   2   2   2   2   2   2   2   2   2   2   186 191 191 191 191 184 2
2   186 191 191 191 191 184 2   2   2   2   2   2   2   2   2   2   2   2   2   2   186 191 191 191 191 184 2
1   191 191 191 191 191 184 2   2   2   2   2   2   2   2   2   2   2   2   2   2   186 191 191 191 191 191 1
2   186 191 191 191 191 184 2   2   2   2   2   2   2   2   2   2   2   2   2   2   186 191 191 191 191 184 2
2   186 191 191 191 191 184 2   2   2   2   2   2   2   2   2   2   2   2   2   2   186 191 191 191 191 184 2
1   191 191 191 191 191 184 2   2   2   2   2   2   2   2   2   2   2   2   2   2   186 191 191 191 191 191 1
2   186 191 191 191 191 184 2   2   2   2   2   2   2   2   2   2   2   2   2   2   186 191 191 191 191 184 2
2   186 191 191 191 191 184 2   2   2   2   2   2   2   2   2   2   2   2   2   2   186 191 191 191 191 184 2
1   191 191 191 191 191 184 2   2   2   2   2   2   2   2   2   2   2   2   2   2   186 191 191 191 191 191 1
2   186 191 191 191 191 184 2   2   2   2   2   2   2   2   2   2   2   2   2   2   186 191 191 191 191 184 2
2   186 191 191 191 191 184 2   2   2   2   2   2   2   2   2   2   2   2   2   2   186 191 191 191 191 184 2
1   191 191 191 191 191 184 2   2   2   2   2   2   2   2   2   2   2   2   2   2   186 191 191 191 191 191 1
2   186 191 191 191 191 170 2   2   2   2   2   2   2   2   2   2   2   2   2   2   170 191 191 191 191 184 2
2   186 191 191 191 191 176 2   2   2   2   2   2   2   2   2   2   2   2   2   2   176 191 191 191 191 184 2
1   191 191 191 191 191 191 1   2   2   2   2   2   2   2   2   2   2   2   2   1   191 191 191 191 191 191 1
2   186 191 191 191 191 184 2   2   2   2   2   2   2   2   2   2   2   2   2   2   186 191 191 191 191 184 2
2   186 191 191 191 191 184 2   2   2   2   2   2   2   2   2   2   2   2   2   2   186 191 191 191 191 184 2
2   187 188 188 188 188 189 2   2   2   2   2   2   2   2   2   2   2   2   2   2   187 188 188 188 188 189 2
2   2   2   2   2   2   2   2   2   2   2   2   2   2   2   2   2   2   2   2   2   2   2   2   2   2   2   2
168 27 5
168 27 8
168 27 11
168 27 14
168 27 17
168 27 21
168 0 5
168 0 8
168 0 11
168 0 14
168 0 17
168 0 21
190 7 20
191 20 20


