







75  75  75  75  75  75  75  75  75  75  75  75  75  75  76  170 170 170 170 170 170 170 170 170 170 170 170 170 170 170 170 170 170 170 170 170 170 170 170 170 170 170 170 170 170 170 74  75  75  75  75  75  75  75  75  75  76  184 185 185 185 185 185 185 185 185 185 185 185 185 185 185 185 185 185 185 185 185 185 185 185 185 185
75  75  75  75  75  75  75  75  75  75  75  75  75  75  76  170 170 170 170 170 170 170 170 170 170 170 170 170 170 170 170 170 170 170 170 170 170 170 170 170 170 170 170 170 170 170 74  75  75  75  75  75  75  75  75  75  76  184 185 185 185 185 185 185 185 185 185 185 185 185 185 185 185 185 185 185 185 185 185 185 185 185 185
75  75  75  75  75  75  75  75  75  75  75  75  75  75  76  170 170 170 170 170 170 170 170 170 170 170 170 170 170 170 170 170 170 170 170 170 170 170 170 170 170 170 170 170 170 170 74  75  75  75  75  75  75  75  75  75  76  184 185 185 185 185 185 185 185 185 185 185 185 185 185 185 185 185 185 185 185 185 185 185 185 185 185
75  75  75  75  75  75  75  75  75  75  75  75  75  75  76  170 170 170 170 170 170 170 170 170 170 170 170 170 170 170 170 170 170 170 170 170 170 170 170 170 170 170 170 170 170 170 74  75  75  75  75  75  75  75  75  75  76  184 185 185 185 185 185 185 185 185 185 185 185 185 185 185 185 185 185 185 185 185 185 185 185 185 185
75  75  75  75  75  75  75  75  75  75  75  75  75  75  76  170 170 170 170 170 170 170 170 170 170 170 170 170 170 170 170 170 170 170 170 170 170 170 170 170 170 170 170 170 170 170 74  75  75  75  75  75  75  75  75  75  76  184 185 185 185 185 185 185 185 185 185 185 185 185 185 185 185 185 185 185 185 185 185 185 185 185 185
75  75  75  75  75  75  75  75  75  75  75  75  75  75  76  170 170 170 170 170 170 170 170 170 170 170 170 170 170 170 170 170 170 170 170 170 170 170 170 170 170 170 170 170 170 170 74  75  75  75  75  75  75  75  75  75  76  184 185 185 185 185 185 185 185 185 185 185 185 185 185 185 185 185 185 185 185 185 185 185 185 185 185
75  75  75  75  75  75  75  75  75  75  75  75  75  75  76  170 170 170 170 170 170 170 170 170 170 170 170 170 170 170 170 170 170 170 170 170 170 170 170 170 170 170 170 170 170 170 74  75  75  75  75  75  75  75  75  75  76  184 185 185 185 185 185 185 185 185 185 185 185 185 185 185 185 185 185 185 185 185 185 185 185 185 185
75  75  75  75  75  75  75  75  75  75  75  75  75  75  76  170 170 170 170 170 170 170 170 170 170 170 170 170 170 170 170 170 170 170 170 170 170 170 170 170 170 170 170 170 170 170 74  75  75  75  75  75  75  75  75  75  76  184 185 185 185 185 185 185 185 185 185 185 185 185 185 185 185 185 185 185 185 185 185 185 185 185 185
75  75  75  75  75  75  75  75  75  75  75  75  75  75  76  170 170 170 170 170 170 170 170 170 170 170 170 170 170 170 170 170 170 170 170 170 170 170 170 170 170 170 170 170 170 170 74  75  75  75  75  75  75  75  75  75  76  184 185 185 185 185 185 185 185 185 185 185 185 185 185 185 185 185 185 185 185 185 185 185 185 185 185
75  75  75  75  75  75  75  75  75  75  75  75  75  75  76  170 170 170 170 170 170 170 170 170 170 170 170 170 170 170 170 170 170 170 170 170 170 170 170 170 170 170 170 170 170 170 74  75  75  75  75  75  75  75  75  75  76  184 185 185 185 185 185 185 185 185 185 185 185 185 185 185 185 185 185 185 185 185 185 185 185 185 185
75  75  75  75  75  75  75  75  75  75  75  75  75  75  76  170 170 170 170 170 170 170 170 170 170 170 170 170 170 170 170 170 170 170 170 170 170 170 170 170 170 170 170 170 170 170 74  75  75  75  75  75  75  75  75  75  76  184 185 185 185 185 185 185 185 185 185 185 185 185 185 185 185 185 185 185 185 185 185 185 185 185 185
75  75  75  75  75  75  75  75  75  75  75  75  75  75  76  170 170 170 170 170 170 170 170 170 170 170 170 170 170 170 170 170 170 170 170 170 170 170 170 170 170 170 170 170 170 170 74  75  75  75  75  75  75  75  75  75  76  184 185 185 185 185 185 185 185 185 185 185 185 185 185 185 185 185 185 185 185 185 185 185 185 185 185
75  75  75  75  75  75  75  75  75  75  75  75  75  75  76  170 170 170 170 170 170 170 170 170 170 170 170 170 170 170 170 170 170 170 170 170 170 170 170 170 170 170 170 170 170 170 74  75  75  75  75  75  75  75  75  75  76  184 185 185 185 185 185 185 185 185 185 185 185 185 185 185 185 185 185 185 185 185 185 185 185 185 185
75  75  75  75  75  75  75  75  75  75  75  75  75  75  76  170 170 170 170 170 170 170 170 170 170 170 170 170 170 170 170 170 170 170 170 170 170 170 170 170 170 170 170 170 170 170 74  75  75  75  75  75  75  75  75  75  76  184 185 185 185 185 185 185 185 185 185 185 185 185 185 185 185 185 185 185 185 185 185 185 185 185 185
75  75  75  75  75  75  75  75  75  75  75  75  75  75  76  170 170 170 170 170 170 170 170 170 170 170 170 170 170 170 170 170 170 170 170 170 170 170 170 170 170 170 170 170 170 170 74  75  75  75  75  75  75  75  75  75  76  184 185 185 185 185 185 185 185 185 185 185 185 185 185 185 185 185 185 185 185 185 185 185 185 185 185
75  75  75  75  75  75  75  75  75  75  75  75  75  75  76  170 170 170 170 170 170 170 170 170 170 170 170 170 170 170 170 170 170 170 170 170 170 170 170 170 170 170 170 170 170 170 74  75  75  75  75  75  75  75  75  75  76  184 185 185 185 185 185 185 185 185 185 185 185 185 185 185 185 185 185 185 185 185 185 185 185 185 185
75  75  75  75  75  75  75  75  75  75  75  75  75  75  76  170 170 170 170 170 170 170 170 170 170 170 170 170 170 170 170 170 170 170 170 170 170 170 170 170 170 170 170 170 170 170 74  75  75  75  75  75  75  75  75  75  76  184 185 185 185 185 185 185 185 185 185 185 185 185 185 185 185 185 185 185 185 185 185 185 185 185 185
75  75  75  75  75  75  75  75  75  75  75  75  75  75  76  170 170 170 170 170 170 170 170 170 170 170 170 170 170 170 170 170 170 170 170 170 170 170 170 170 170 170 170 170 170 170 74  75  75  75  75  75  75  75  75  75  76  184 185 185 185 185 185 185 185 185 185 185 185 185 185 185 185 185 185 185 185 185 185 185 185 185 185
75  75  75  75  75  75  75  75  75  75  75  75  75  75  76  170 170 170 170 170 170 170 170 170 170 170 170 170 170 170 170 170 170 170 170 170 170 170 170 170 170 176 176 176 176 176 74  75  75  75  75  75  75  75  75  75  76  184 185 185 185 185 185 185 185 185 185 185 185 185 185 185 185 185 185 185 185 185 185 185 185 185 185
75  75  75  75  75  75  75  75  75  75  75  75  75  75  75  72  72  72  72  72  170 170 170 170 170 170 170 170 170 170 170 170 170 170 170 170 170 170 170 170 170 170 170 170 170 170 74  75  75  75  75  75  75  75  75  75  76  184 185 185 185 185 185 185 185 185 185 185 185 185 185 185 185 185 185 185 185 185 185 185 185 185 185
75  75  75  75  75  75  75  75  75  75  75  75  75  75  75  75  75  75  75  76  170 170 170 170 170 170 170 170 170 170 170 170 170 170 170 170 170 170 170 170 170 170 170 170 170 170 74  75  75  75  75  75  75  75  75  75  76  184 185 185 185 185 185 185 185 185 185 185 185 185 185 185 185 185 185 185 185 185 185 185 185 185 185
75  75  75  75  75  75  75  75  75  75  75  75  75  75  75  75  75  75  75  76  170 170 170 170 170 170 170 170 170 170 170 170 170 170 170 170 170 170 170 170 170 170 170 170 170 170 74  75  75  75  75  75  75  75  75  75  76  184 185 185 185 185 185 185 185 185 185 185 185 185 185 185 185 185 185 185 185 185 185 185 185 185 185
75  75  75  75  75  75  75  75  75  75  75  75  75  75  75  75  75  75  75  76  176 176 176 176 176 176 176 176 176 176 176 176 176 176 176 176 176 176 176 176 176 176 176 176 176 176 74  75  75  75  75  75  75  75  75  75  76  184 185 185 185 185 185 185 185 185 185 185 185 185 185 185 185 185 185 185 185 185 185 185 185 185 185
75  75  75  75  75  75  75  75  75  75  75  75  75  75  75  75  75  75  75  75  72  72  72  72  72  72  72  72  72  72  72  72  72  72  72  72  72  72  72  72  72  72  72  72  72  72  75  75  75  75  75  75  75  75  75  75  76  184 185 185 185 185 185 185 185 185 185 185 185 185 185 185 185 185 185 185 185 185 185 185 185 185 185
75  75  75  75  75  75  75  75  75  75  75  75  75  75  75  75  75  75  75  75  75  75  75  75  75  75  75  75  75  75  75  75  75  75  75  75  75  75  75  75  75  75  75  75  75  75  75  75  75  75  75  75  75  75  75  75  76  184 185 185 185 185 185 185 185 185 185 185 185 185 185 185 185 185 185 185 185 185 185 185 185 185 185
75  75  75  75  75  75  75  75  75  75  75  75  75  75  75  75  75  75  75  75  75  75  75  75  75  75  75  75  75  75  75  75  75  75  75  75  75  75  75  75  75  75  75  75  75  75  75  75  75  75  75  75  75  75  75  75  76  184 185 185 185 185 185 185 185 185 185 185 185 185 185 185 185 185 185 185 185 185 185 185 185 185 185
75  75  75  75  75  75  75  75  75  75  75  75  75  75  75  75  75  75  75  75  75  75  75  75  75  75  75  75  75  75  75  75  75  75  75  75  75  75  75  75  75  75  75  75  75  75  75  75  75  75  75  75  75  75  75  75  76  188 188 188 188 188 188 188 188 188 188 188 188 188 188 188 183 185 185 185 185 185 185 185 185 185 185
75  75  75  75  75  75  75  75  75  75  75  75  75  75  75  75  75  75  75  75  75  75  75  75  75  75  75  75  75  75  75  75  75  75  75  75  75  75  75  75  75  75  75  75  75  75  75  75  75  75  75  75  75  75  75  75  76  170 170 170 170 170 170 170 170 170 170 170 170 170 170 170 184 185 185 185 185 185 185 185 185 185 185
75  75  75  75  75  75  75  75  75  75  75  75  75  75  75  75  75  75  75  75  75  75  75  75  75  75  75  75  75  75  75  75  75  75  75  75  75  75  75  75  75  75  75  75  75  75  75  75  75  75  75  75  75  75  75  75  76  176 176 176 176 176 176 176 176 1   176 176 176 176 176 176 184 185 185 185 185 185 185 185 185 185 185
75  75  75  75  75  75  75  75  75  75  75  75  75  75  75  75  75  75  75  75  75  75  75  75  75  75  75  75  75  75  75  75  75  75  75  75  75  75  75  75  75  75  75  75  75  75  75  75  75  75  75  75  75  75  75  75  75  72  72  72  72  72  72  72  72  75  72  72  72  72  72  73  184 185 185 185 185 185 185 185 185 185 185
75  75  75  75  75  75  75  75  75  75  75  75  75  75  75  75  75  75  75  75  75  75  75  75  75  75  75  75  75  75  75  75  75  75  75  75  75  75  75  75  75  75  75  75  75  75  75  75  75  75  75  75  75  75  75  75  75  75  75  75  75  75  75  75  75  75  75  75  75  75  75  76  184 185 185 185 185 185 185 185 185 185 185
75  75  75  75  75  75  75  75  75  75  75  75  75  75  75  75  75  75  75  75  75  75  75  75  75  75  75  75  75  75  75  75  75  75  75  75  75  75  75  75  75  75  75  75  75  75  75  75  75  75  75  75  75  75  75  75  75  75  75  75  75  75  75  75  75  75  75  75  75  75  75  76  170 185 185 185 185 185 185 185 185 185 185
75  75  75  75  75  75  75  75  75  75  75  75  75  75  75  75  75  75  75  75  75  75  75  75  75  75  75  75  75  75  75  75  75  75  75  75  75  75  75  75  75  75  75  75  75  75  75  75  75  75  75  75  75  75  75  75  75  75  75  75  75  75  75  75  75  75  75  75  75  75  75  76  176 185 185 185 185 185 185 185 185 185 185
75  75  75  75  75  75  75  75  75  75  75  75  75  75  75  75  75  75  75  75  75  75  75  75  75  75  75  75  75  75  75  75  75  75  75  75  75  75  75  75  75  75  75  75  75  75  75  75  75  75  75  75  75  75  75  75  75  75  75  75  75  75  75  75  75  75  75  75  75  75  75  75  1   185 185 185 185 185 185 185 185 185 185
75  75  75  75  75  75  75  75  75  75  75  75  75  75  75  75  75  75  75  75  75  75  75  75  75  75  75  75  75  75  75  75  75  75  75  75  75  75  75  75  75  75  75  75  75  75  75  75  75  75  75  75  75  75  75  75  75  75  75  75  75  75  75  75  75  75  75  75  75  75  75  76  184 185 185 185 185 185 185 185 185 185 185
75  75  75  75  75  75  75  75  75  75  75  75  75  75  75  75  75  75  75  75  75  75  75  75  75  75  75  75  75  75  75  75  75  75  75  75  75  75  75  75  75  75  75  75  75  75  75  75  75  75  75  75  75  75  75  75  75  75  75  75  75  75  75  75  75  75  75  75  75  75  75  76  184 185 185 185 185 185 185 185 185 185 185
75  75  75  75  75  75  75  75  75  75  75  75  75  75  75  75  75  75  75  75  75  75  75  75  75  75  75  75  75  75  75  75  75  75  75  75  75  75  75  75  75  75  75  75  75  75  75  75  75  75  75  75  75  75  75  75  75  75  75  75  75  75  75  75  75  75  75  75  75  75  75  76  184 185 185 185 185 185 185 185 185 185 185
75  75  75  75  75  75  75  75  75  75  75  75  75  75  75  75  75  75  75  75  75  75  75  75  75  75  75  75  75  75  75  75  75  75  75  75  75  75  75  75  75  75  75  75  75  75  75  75  75  75  75  75  75  75  75  75  75  75  75  75  75  75  75  75  75  75  75  75  75  75  75  76  184 185 185 185 185 185 185 185 185 185 185
75  75  75  75  75  75  75  75  75  75  75  75  75  75  75  75  75  75  75  75  75  75  75  75  75  75  75  75  75  75  75  75  75  75  75  75  75  75  75  75  75  75  75  75  75  75  75  75  75  75  75  75  75  75  75  75  75  78  78  78  78  78  78  78  78  78  78  78  78  78  78  79  184 185 185 185 185 185 185 185 185 185 185
75  75  75  75  75  75  75  75  75  75  75  75  75  75  75  75  75  75  75  75  75  75  75  75  75  75  75  75  75  75  75  75  75  75  75  75  75  75  75  75  75  75  75  75  75  75  75  75  75  75  75  75  75  75  75  75  76  181 182 182 182 182 182 182 182 182 182 182 182 182 182 182 189 185 185 185 185 185 185 185 185 185 185
75  75  75  75  75  75  75  75  75  75  75  75  75  75  75  75  75  75  75  75  75  75  75  75  75  75  75  75  75  75  75  75  75  75  75  75  75  75  75  75  75  75  75  75  75  75  75  75  75  75  75  75  75  75  75  75  76  184 185 185 185 185 185 185 185 185 185 185 185 185 185 185 185 185 185 185 185 185 185 185 185 185 185
75  75  75  75  75  75  75  75  75  75  75  75  75  75  75  75  75  75  75  75  75  75  75  75  75  75  75  75  75  75  75  75  75  75  75  75  75  75  75  75  75  75  75  75  75  75  75  75  75  75  75  75  75  75  75  75  76  184 185 185 185 185 185 185 185 185 185 185 185 185 185 185 185 185 185 185 185 185 185 185 185 185 185
75  75  75  75  75  75  75  75  75  75  75  75  75  75  75  75  75  75  75  75  75  75  75  75  75  75  75  75  75  75  75  75  75  75  75  75  75  75  75  75  75  75  75  75  75  75  75  75  75  75  75  75  75  75  75  75  76  184 185 185 185 185 185 185 185 185 185 185 185 185 185 185 185 185 185 185 185 185 185 185 185 185 185
75  75  75  75  75  75  75  75  75  75  75  75  75  75  75  75  75  75  75  75  75  75  75  75  75  75  75  75  75  75  75  75  75  75  75  75  75  75  75  75  75  75  75  75  75  75  75  75  75  75  75  75  75  75  75  75  76  184 185 185 185 185 185 185 185 185 185 185 185 185 185 185 185 185 185 185 185 185 185 185 185 185 185
75  75  75  75  75  75  75  75  75  75  75  75  75  75  75  75  75  75  75  75  75  75  75  75  75  75  75  75  75  75  75  75  75  75  75  75  75  75  75  75  75  75  75  75  75  75  75  75  75  75  75  75  75  75  75  75  76  184 185 185 185 185 185 185 185 185 185 185 185 185 185 185 185 185 185 185 185 185 185 185 185 185 185
75  75  75  75  75  75  75  75  75  75  75  75  75  75  75  75  75  75  75  75  75  75  75  75  75  75  75  75  75  75  75  75  75  75  75  75  75  75  75  75  75  75  75  75  75  75  75  75  75  75  75  75  75  75  75  75  76  184 185 185 185 185 185 185 185 185 185 185 185 185 185 185 185 185 185 185 185 185 185 185 185 185 185
75  75  75  75  75  75  75  75  75  75  75  75  75  75  75  75  75  75  75  75  75  75  75  75  75  75  75  75  75  75  75  75  75  75  75  75  75  75  75  75  75  75  75  75  75  75  75  75  75  75  75  75  75  75  75  75  76  184 185 185 185 185 185 185 185 185 185 185 185 185 185 185 185 185 185 185 185 185 185 185 185 185 185
75  75  75  75  75  75  75  75  75  75  75  75  75  75  75  75  75  75  75  75  75  75  75  75  75  75  75  75  75  75  75  75  75  75  75  75  75  75  75  75  75  75  75  75  75  75  75  75  75  75  75  75  75  75  75  75  76  184 185 185 185 185 185 185 185 185 185 185 185 185 185 185 185 185 185 185 185 185 185 185 185 185 185
75  75  75  75  75  75  75  75  75  75  75  75  75  75  75  75  75  75  75  75  75  75  75  75  75  75  75  75  75  75  75  75  75  75  75  75  75  75  75  75  75  75  75  75  75  75  75  75  75  75  75  75  75  75  75  75  76  184 185 185 185 185 185 185 185 185 185 185 185 185 185 185 185 185 185 185 185 185 185 185 185 185 185
75  75  75  75  75  75  75  75  75  75  75  75  75  75  75  75  75  75  75  75  75  75  75  75  75  75  75  75  75  75  75  75  75  75  75  75  75  75  75  75  75  75  75  75  75  75  75  75  75  75  75  75  75  75  75  75  76  184 185 185 185 185 185 185 185 185 185 185 185 185 185 185 185 185 185 185 185 185 185 185 185 185 185
75  75  75  75  75  75  75  75  75  75  75  75  75  75  75  75  75  75  75  75  75  75  75  75  75  75  75  75  75  78  78  78  78  78  78  78  78  78  78  78  78  78  78  78  78  78  78  78  78  78  75  75  75  75  75  75  76  184 185 185 185 185 185 185 185 185 185 185 185 185 185 185 185 185 185 185 185 185 185 185 185 185 185
75  75  75  75  75  75  75  75  75  75  75  75  75  75  75  75  75  75  75  75  75  75  75  75  75  75  75  75  76  181 182 182 182 182 182 182 182 182 182 182 182 182 182 182 182 182 182 182 182 183 74  75  75  75  75  75  76  184 185 185 185 185 185 185 185 185 185 185 185 185 185 185 185 185 185 185 185 185 185 185 185 185 185
75  75  75  75  75  75  75  75  75  75  75  75  75  75  75  75  75  75  75  75  75  75  75  75  75  75  75  75  76  184 185 185 185 185 185 185 185 185 185 185 185 185 185 185 185 185 185 185 185 186 75  75  75  75  75  75  76  184 185 185 185 185 185 185 185 185 185 185 185 185 185 185 185 185 185 185 185 185 185 185 185 185 185
75  75  75  75  75  75  75  75  75  75  75  75  75  75  75  75  75  75  75  75  75  75  75  75  75  75  75  75  76  184 185 185 185 185 185 185 185 185 185 185 185 185 185 185 185 185 185 185 185 186 74  75  75  75  75  75  76  184 185 185 185 185 185 185 185 185 185 185 185 185 185 185 185 185 185 185 185 185 185 185 185 185 185
75  75  75  75  75  75  75  75  75  75  75  75  75  75  75  75  75  75  75  75  75  75  75  75  75  75  75  75  76  184 185 185 185 185 185 185 185 185 185 185 185 185 185 185 185 185 185 185 185 186 74  75  75  75  75  75  76  184 185 185 185 185 185 185 185 185 185 185 185 185 185 185 185 185 185 185 185 185 185 185 185 185 185
75  75  75  75  75  75  75  75  75  75  75  75  75  75  75  75  75  75  75  75  75  75  75  75  75  75  75  75  76  184 185 185 185 185 185 185 185 185 185 185 185 185 185 185 185 185 185 185 185 186 74  75  75  75  75  75  76  184 185 185 185 185 185 185 185 185 185 185 185 185 185 185 185 185 185 185 185 185 185 185 185 185 185
75  75  75  75  75  75  75  75  75  75  75  75  75  75  75  75  75  75  75  75  75  75  75  75  75  75  75  75  76  184 185 185 185 185 185 185 185 185 185 185 185 185 185 185 185 185 185 185 185 186 74  75  75  75  75  75  76  184 185 185 185 185 185 185 185 185 185 185 185 185 185 185 185 185 185 185 185 185 185 185 185 185 185
75  75  75  75  75  75  75  75  75  75  75  75  75  75  75  75  75  75  75  75  75  75  75  75  75  75  75  75  76  184 185 185 185 185 185 185 185 185 185 185 185 185 185 185 185 185 185 185 185 186 74  75  75  75  75  75  76  187 182 182 182 182 182 182 182 182 182 182 182 182 182 182 182 182 182 182 182 185 185 185 185 185 185
75  75  75  75  75  75  75  75  75  75  75  75  75  75  75  75  75  75  75  75  75  75  75  75  75  75  75  75  76  187 188 191 188 188 188 188 188 188 188 188 188 188 188 188 188 188 191 188 188 189 74  75  75  75  75  75  76  170 170 170 170 184 185 185 185 185 185 185 185 185 185 185 185 185 185 185 185 185 185 185 185 185 185
75  75  75  75  75  75  75  75  75  75  75  75  75  75  75  75  75  75  75  75  75  75  75  75  75  75  75  75  76  170 170 170 170 170 170 170 170 170 170 170 170 170 170 170 170 170 170 170 170 170 74  75  75  75  75  75  76  176 176 176 176 184 185 185 185 185 185 185 185 185 185 185 185 185 185 185 185 185 185 185 185 185 185
75  75  75  75  75  75  75  75  75  75  75  75  75  75  75  75  75  75  75  75  75  75  75  77  77  77  77  77  78  176 176 176 176 176 176 176 176 176 176 176 176 176 176 176 176 176 1   176 176 176 74  75  75  75  75  75  75  72  72  72  73  184 185 185 185 185 185 185 185 185 185 185 185 185 185 185 185 185 185 185 185 185 185
75  75  75  75  75  75  75  75  75  75  75  75  75  75  75  75  75  75  75  75  75  75  76  181 182 182 182 182 182 182 182 182 182 182 182 182 182 182 182 182 182 182 183 71  72  72  75  72  72  72  75  75  75  75  75  75  75  75  75  75  76  184 185 185 185 185 185 185 185 185 185 185 185 185 185 185 185 185 185 185 185 185 185
75  75  75  75  75  75  75  75  75  75  75  75  75  75  75  75  75  75  75  75  75  75  76  184 185 185 185 185 185 185 185 185 185 185 185 185 185 185 185 185 185 185 186 74  75  75  75  75  75  75  75  75  75  75  75  75  75  75  75  75  76  184 185 185 185 185 185 185 185 185 185 185 185 185 185 185 185 185 185 185 185 185 185
75  75  75  75  75  75  75  75  75  75  75  75  75  75  75  75  75  75  75  75  75  75  76  184 185 185 185 185 185 185 185 185 185 185 185 185 185 185 185 185 185 185 186 74  75  75  75  75  75  75  75  75  75  75  75  75  75  75  75  75  76  184 185 185 185 185 185 185 185 185 185 185 185 185 185 185 185 185 185 185 185 185 185
75  75  75  75  75  75  75  75  75  75  75  75  75  75  75  75  75  75  75  75  75  75  76  184 185 185 185 185 185 185 185 185 185 185 185 185 185 185 185 185 185 185 186 74  75  75  75  75  75  75  75  75  75  75  75  75  75  75  75  75  76  184 185 185 185 185 185 185 185 185 185 185 185 185 185 185 185 185 185 185 185 185 185
75  75  75  75  75  75  75  75  75  75  75  75  75  75  75  75  75  75  75  75  75  75  76  184 185 185 185 185 185 185 185 185 185 185 185 185 185 185 185 185 185 185 186 74  75  75  75  75  75  75  75  75  75  75  75  75  75  75  75  75  76  184 185 185 185 185 185 185 185 185 185 185 185 185 185 185 185 185 185 185 185 185 185
75  75  75  75  75  75  75  75  75  75  75  75  75  75  75  75  75  75  75  75  75  75  76  184 185 185 185 185 185 185 185 185 185 185 185 185 185 185 185 185 185 185 186 74  75  75  75  75  75  75  75  75  75  75  75  75  75  75  75  75  76  184 185 185 185 185 185 185 185 185 185 185 185 185 185 185 185 185 185 185 185 185 185
75  75  75  75  75  75  75  75  75  75  75  75  75  75  75  75  75  75  75  75  75  75  76  184 185 185 185 185 185 185 185 185 185 185 185 185 185 185 185 185 185 185 186 74  75  75  75  75  75  75  75  75  75  75  75  75  75  75  75  75  76  184 185 185 185 185 185 185 185 185 185 185 185 185 185 185 185 185 185 185 185 185 185
75  75  75  75  75  75  75  75  75  75  75  75  75  75  75  75  75  75  75  75  75  75  76  184 185 185 185 185 185 185 185 185 185 185 185 185 185 185 185 185 185 185 186 74  75  75  75  75  75  75  75  75  75  75  75  75  75  75  75  75  76  184 185 185 185 185 185 185 185 185 185 185 185 185 185 185 185 185 185 185 185 185 185
75  75  75  75  75  75  75  75  75  75  75  75  75  75  75  75  75  75  75  75  75  75  76  184 185 185 185 185 185 185 185 185 185 185 185 185 185 185 185 185 185 185 186 77  78  78  78  78  78  78  78  78  78  78  78  75  75  75  75  75  76  184 185 185 185 185 185 185 185 185 185 185 185 185 185 185 185 185 185 185 185 185 185
75  75  75  75  75  75  75  75  75  75  75  75  75  75  75  75  75  75  75  75  75  75  76  184 185 185 185 185 185 185 185 185 185 185 185 185 185 185 185 185 185 185 187 182 182 182 182 182 182 182 182 182 182 182 183 74  75  75  75  75  76  184 185 185 185 185 185 185 185 185 185 185 185 185 185 185 185 185 185 185 185 185 185
75  75  75  75  75  75  75  75  75  75  75  75  75  75  75  75  75  75  75  75  75  75  76  184 185 185 185 185 185 185 185 185 185 185 185 185 185 185 185 185 185 185 185 185 185 185 185 185 185 185 185 185 185 185 186 74  75  75  75  75  76  184 185 185 185 185 185 185 185 185 185 185 185 185 185 185 185 185 185 185 185 185 185
75  75  75  75  75  75  75  75  75  75  75  75  75  75  75  75  75  75  75  75  75  75  76  184 185 185 185 185 185 185 185 185 185 185 185 185 185 185 185 185 185 185 185 185 185 185 185 185 185 185 185 185 185 185 186 74  75  75  75  75  76  184 185 185 185 185 185 185 185 185 185 185 185 185 185 185 185 185 185 185 185 185 185
75  75  75  75  75  75  75  75  75  75  75  75  75  75  75  75  75  75  75  75  75  75  76  184 185 185 185 185 185 185 185 185 185 185 185 185 185 185 185 185 185 185 185 185 185 185 185 185 185 185 185 185 185 185 186 74  75  75  75  75  76  184 185 185 185 185 185 185 185 185 185 185 185 185 185 185 185 185 185 185 185 185 185
75  75  75  75  75  75  75  75  75  75  75  75  75  75  75  75  75  75  75  75  75  75  76  184 185 185 185 185 185 185 185 185 185 185 185 185 185 185 185 185 185 185 185 185 185 185 185 185 185 185 185 185 185 185 186 74  75  75  75  75  76  184 185 185 185 185 185 185 185 185 185 185 185 185 185 185 185 185 185 185 185 185 185
75  75  75  75  75  75  75  75  75  75  75  75  75  75  75  75  75  75  75  75  75  75  76  184 185 185 185 185 185 185 185 185 185 185 185 185 185 185 185 185 185 185 185 185 185 185 185 185 185 185 185 185 185 185 186 74  75  75  75  75  76  184 185 185 185 185 185 185 185 185 185 185 185 185 185 185 185 185 185 185 185 185 185
75  75  75  75  75  75  75  75  75  75  75  75  75  75  75  75  75  75  75  75  75  75  76  184 185 185 185 185 185 185 185 185 185 185 185 185 185 185 185 185 185 185 185 185 185 185 185 185 185 185 185 185 185 185 186 74  75  75  75  75  76  184 185 185 185 185 185 185 185 185 185 185 185 185 185 185 185 185 185 185 185 185 185
75  75  75  75  75  75  75  75  75  75  75  75  75  75  75  75  75  75  75  75  75  75  76  184 185 185 185 185 185 185 185 185 185 185 185 185 185 185 185 185 185 185 185 185 185 185 185 185 185 185 185 185 185 185 186 74  75  75  75  75  76  184 185 185 185 185 185 185 185 185 185 185 185 185 185 185 185 185 185 185 185 185 185
75  75  75  75  75  75  75  75  75  75  75  75  75  75  75  75  75  75  75  75  75  75  76  184 185 185 185 185 185 185 185 185 185 185 185 185 185 185 185 185 185 185 185 185 185 185 185 185 185 185 185 185 185 185 186 74  75  75  75  75  76  184 185 185 185 185 185 185 185 185 185 185 185 185 185 185 185 185 185 185 185 185 185
75  75  75  75  75  75  75  75  75  75  75  75  75  75  75  75  75  75  75  75  75  75  76  184 185 185 185 185 185 185 185 185 185 185 185 185 185 185 185 185 185 185 185 185 185 185 185 185 185 185 185 185 185 185 186 74  75  75  75  75  76  184 185 185 185 185 185 185 185 185 185 185 185 185 185 185 185 185 185 185 185 185 185
75  75  75  75  75  75  75  75  75  75  75  75  75  75  75  75  75  75  75  75  75  75  76  184 185 185 185 185 185 185 185 185 185 185 185 185 185 185 185 185 185 185 185 185 185 185 185 185 185 185 185 185 185 185 186 74  75  75  75  75  76  184 185 185 185 185 185 185 185 185 185 185 185 185 185 185 185 185 185 185 185 185 185