10 11
12 15
0
0 0
2   2   2   2   2   2   2   2   2   2
2   181 182 182 182 182 182 182 182 2
2   186 170 170 170 170 170 170 170 2
2   186 176 176 176 176 176 176 195 1
2   186 191 191 191 191 191 195 195 1
2   170 191 191 191 191 195 195 195 1
2   176 191 191 191 191 195 195 2   2
1   191 191 191 191 191 195 184 2   2
2   186 191 191 191 191 191 184 2   2
2   187 188 188 188 188 188 189 2   2
2   2   2   2   2   2   2   2   2   2