13 20
11 23
2
0
0 0
2   2   2   2   2   2   2   2   2   2   2   2   2
2   181 188 188 188 188 1   188 188 188 188 183 2
2   186 170 170 170 170 191 170 170 170 170 184 2
2   186 176 176 176 176 191 176 176 176 176 184 2
2   184 191 191 191 191 191 191 191 191 191 184 2   
2   186 191 191 191 191 191 191 191 191 191 184 2
2   186 191 191 191 191 191 191 191 191 191 184 2
2   186 191 191 191 191 191 191 191 191 191 184 2
2   186 191 191 191 191 191 191 191 191 191 184 2
2   186 191 191 191 191 191 191 191 191 191 184 2
2   186 191 191 191 191 191 191 191 191 191 184 2
2   186 191 191 191 191 191 191 191 191 191 184 2
2   186 191 191 191 191 191 191 191 191 191 184 2
2   186 191 191 191 191 191 191 191 191 191 184 2
2   186 191 191 191 191 191 191 191 191 191 184 2
2   186 191 191 191 191 191 191 191 191 191 184 2
2   186 191 191 191 191 191 191 191 191 191 184 2
2   186 191 191 191 191 191 191 191 191 191 184 2
2   187 188 188 188 188 1   188 188 188 188 189 2
2   2   2   2   2   2   2   2   2   2   2   2   2
169 6 18
170 6 1
