37 32
18 27
0
0
0 0
1	1	1	1	1	1	1	1	1	1	1	1	1	1	1	1	1	1	1	1	1	1	1	1	1	1	1	1	1	1	1	1	1	1	1	1	1	
1	1	1	1	1	1	1	1	1	1	1	1	1	1	1	1	1	1	1	1	1	1	1	1	1	1	1	1	1	1	1	1	1	1	1	1	1	
1	1	1	1	1	1	1	1	1	1	1	1	1	1	1	1	1	1	1	1	1	1	1	1	1	1	1	1	1	1	1	1	1	1	1	1	1	
1	1	1	1	1	1	1	1	1	1	1	1	1	1	1	1	1	1	1	16	16	16	16	16	16	16	16	16	16	16	1	1	1	1	1	1	1
1	1	1	1	1	1	1	1	1	1	1	1	1	1	1	1	1	1	1	16	16	16	16	16	16	16	16	16	16	16	1	1	1	1	1	1	1
1	1	1	1	1	1	1	1	1	1	1	1	1	1	1	1	1	1	1	16	16	16	16	16	16	16	16	16	16	16	1	1	1	1	1	1	1
1	1	1	1	1	1	1	1	1	1	1	1	1	1	1	1	1	1	1	16	16	16	16	16	16	16	16	16	16	16	1	1	1	1	1	1	1
1	1	1	1	1	1	1	1	1	1	1	1	1	1	1	1	1	1	1	16	16	16	16	16	16	16	16	16	16	16	1	1	1	1	1	1	1
1	1	1	1	1	1	1	1	1	1	1	1	1	1	1	1	1	1	1	16	16	16	16	16	16	16	16	16	16	16	1	1	1	1	1	1	1
1	1	1	1	1	1	1	1	1	1	1	1	1	1	1	1	1	1	1	17	17	17	17	17	17	17	17	17	17	17	1	1	1	1	1	1	1
1	1	1	1	1	1	1	1	1	1	1	1	1	1	1	1	1	1	1	17	17	17	17	17	17	17	17	17	17	17	1	1	1	1	1	1	1
1	1	1	1	1	1	20	2	2	2	2	2	2	2	2	2	2	2	2	17	17	17	17	17	17	17	17	17	17	17	1	1	1	1	1	1	1
1	1	1	1	1	20	20	2	2	2	2	2	2	2	2	2	2	2	2	17	17	17	17	17	17	17	17	17	17	17	1	1	1	1	1	1	1
1	1	1	1	20	20	20	2	2	2	2	2	2	2	2	2	2	2	2	17	17	17	17	17	17	17	17	17	17	17	1	1	1	1	1	1	1
16	16	1	0	20	20	16	16	16	2	2	2	2	2	2	2	2	2	2	17	17	17	17	17	17	17	17	17	17	17	1	1	1	1	1	1	1
1	1	1	0	20	1	1	1	16	2	2	2	2	2	2	2	2	2	2	17	17	17	17	17	17	17	17	17	17	17	1	1	1	1	1	1	1
1	1	1	0	1	1	1	1	16	2	2	2	2	2	2	2	2	2	2	17	17	17	17	17	17	17	17	17	17	17	1	1	1	1	1	1	1
1	1	1	1	1	1	1	1	16	2	2	2	2	2	2	2	2	2	2	17	17	17	17	17	17	17	17	17	17	17	1	1	1	1	1	1	1
1	1	1	1	1	1	1	1	16	2	2	2	2	2	2	2	2	2	2	17	17	17	17	17	17	17	17	17	17	17	1	1	1	1	1	1	1
1	1	1	1	1	1	1	1	16	2	2	2	2	2	2	2	2	2	2	17	17	17	0	17	17	17	17	17	17	17	1	1	1	1	1	1	1
1	1	1	1	1	1	1	1	16	16	16	16	16	16	2	2	2	2	2	2	2	2	2	2	2	2	2	17	17	17	1	1	1	1	1	1	1
1	1	1	1	1	1	1	1	1	1	1	1	1	16	2	2	2	2	2	2	2	2	2	2	2	2	2	17	17	17	1	1	1	1	1	1	1
1	1	1	1	1	1	1	1	1	1	1	1	1	16	2	2	2	2	2	2	2	2	2	2	2	2	2	17	17	17	1	1	1	1	1	1	1
1	1	1	1	1	1	1	1	1	1	1	1	1	16	2	2	2	2	2	2	2	2	2	2	2	2	2	17	17	17	1	1	1	1	1	1	1
1	1	1	1	1	1	1	1	1	1	1	1	1	16	2	2	2	2	2	2	2	2	2	2	2	2	2	17	17	17	1	1	1	1	1	1	1
1	1	1	1	1	1	1	1	1	1	1	1	1	16	2	2	2	2	2	2	2	2	2	2	2	2	2	17	17	17	1	1	1	1	1	1	1
1	1	1	1	1	1	1	1	1	1	1	1	1	16	2	2	2	2	2	2	2	2	2	2	2	2	2	17	17	17	1	1	1	1	1	1	1
1	1	1	1	1	1	1	1	1	1	1	1	1	16	16	16	16	16	2	16	16	16	16	16	16	16	16	16	17	17	1	1	1	1	1	1	1
1	1	1	1	1	1	1	1	1	1	1	1	1	1	1	1	1	1	0	1	1	1	1	1	1	1	1	1	1	1	1	1	1	1	1	1	1	
1	1	1	1	1	1	1	1	1	1	1	1	1	1	1	1	1	1	1	1	1	1	1	1	1	1	1	1	1	1	1	1	1	1	1	1	1	
1	1	1	1	1	1	1	1	1	1	1	1	1	1	1	1	1	1	1	1	1	1	1	1	1	1	1	1	1	1	1	1	1	1	1	1	1	
1	1	1	1	1	1	1	1	1	1	1	1	1	1	1	1	1	1	1	1	1	1	1	1	1	1	1	1	1	1	1	1	1	1	1	1	1	
