17 19
11 13
3
7
1 1
1	1	1	1	1	1	1	1	1	1	1	1	1	1	1	1	1
1	1	1	1	1	1	1	1	1	1	1	1	1	1	1	1	1
1	1	1	1	1	1	1	1	1	1	1	1	1	1	1	1	1
1	1	1	16	16	16	16	16	16	16	16	16	1	1	1	1	1
1	1	1	16	17	17	17	17	17	17	17	17	1	1	1	1	1
1	1	1	16	17	17	17	17	17	17	17	17	1	0	1	1	1
1	1	1	16	17	17	17	17	17	17	17	17	20	0	1	1	1
1	1	1	16	27	27	27	27	27	27	27	20	1	1	1	1	1
1	1	1	16	27	27	27	27	27	27	27	16	1	1	1	1	1
1	1	1	16	27	27	27	27	27	27	27	16	1	1	1	1	1
1	1	1	16	27	27	27	27	27	27	27	17	1	1	1	1	1
1	1	1	16	27	27	27	27	27	27	27	17	1	1	1	1	1
1	1	1	16	27	27	27	27	27	27	27	17	1	1	1	1	1
1	1	1	16	27	27	27	27	27	27	27	27	0	1	1	1	1
1	1	1	16	27	27	27	27	27	27	27	16	1	1	1	1	1
1	1	1	16	16	16	16	16	16	16	16	16	1	1	1	1	1
1	1	1	1	1	1	1	1	1	1	1	1	1	1	1	1	1
1	1	1	1	1	1	1	1	1	1	1	1	1	1	1	1	1
1	1	1	1	1	1	1	1	1	1	1	1	1	1	1	1	1
175 12 13
176 13 5
176 13 6
32 352 192
32 384 160
33 352 224
33 384 192
34 352 256
34 384 224
35 384 256
22 10