31 32
12 15
0
0 0
2   2   2   2   2   2   2   2   2   2   2   2   2   2   2   2   2   2   2   2   2   2   2   2   2   2   2   2   2   2   2   2   2   2   2   2
2   2   2   2   2   2   2   2   2   2   181 182 182 182 182 182 182 182 182 182 182 182 182 182 182 183 2   2   2   2   2   2   2   2   2   2
2   2   2   2   2   2   2   2   2   2   184 170 170 170 170 170 170 170 170 170 170 170 170 170 170 186 2   2   2   2   2   2   2   2   2   2
2   2   2   2   2   2   2   2   2   2   184 176 176 176 176 176 176 176 176 176 176 176 176 176 176 186 2   2   2   2   2   2   2   2   2   2
2   2   2   2   2   2   2   2   2   2   184 194 194 194 194 194 194 194 194 194 194 194 194 194 194 186 2   2   2   2   2   2   2   2   2   2
2   2   2   2   2   2   2   2   2   2   184 194 194 194 194 194 194 194 194 194 194 194 194 194 194 186 2   2   2   2   2   2   2   2   2   2
2   2   2   2   2   2   2   2   2   2   184 194 194 194 194 194 194 194 194 194 194 194 194 194 194 186 2   2   2   2   2   2   2   2   2   2
2   2   2   2   2   2   2   2   2   2   184 194 194 194 194 194 194 194 194 194 194 194 194 194 194 186 2   2   2   2   2   2   2   2   2   2
2   2   2   2   2   2   2   2   2   2   184 194 194 194 194 194 181 188 188 188 188 183 194 194 194 186 2   2   2   2   2   2   2   2   2   2
2   2   2   2   2   2   2   2   2   2   184 194 194 194 194 194 186 2   2   2   2   184 194 194 194 186 2   2   2   2   2   2   2   2   2   2
2   2   2   2   2   2   2   2   2   2   184 194 194 194 194 194 186 2   2   2   2   184 194 194 194 186 2   2   2   2   2   2   2   2   2   2
2   2   2   2   2   2   2   2   2   2   187 188 194 188 188 188 189 2   2   2   2   184 194 194 194 186 2   2   2   2   2   2   2   2   2   2
2   2   2   2   2   2   2   2   2   2   2   2   1   2   2   2   2   2   2   2   2   184 194 194 194 186 2   2   2   2   2   2   2   2   2   2
2   2   2   2   2   2   2   2   2   2   2   2   2   2   2   2   2   2   2   2   2   184 194 194 194 186 2   2   2   2   2   2   2   2   2   2
2   2   2   2   2   2   2   2   2   2   2   2   2   2   2   2   2   2   2   2   2   184 194 194 194 186 2   2   2   2   2   2   2   2   2   2
2   2   2   2   2   2   2   2   2   2   2   2   2   2   2   2   2   2   2   2   2   184 194 194 194 186 2   2   2   2   2   2   2   2   2   2
2   2   2   2   2   2   2   2   2   2   2   2   2   2   2   2   2   2   181 188 188 189 194 194 194 186 2   2   2   2   2   2   2   2   2   2
2   2   2   2   2   2   2   2   2   2   2   2   2   2   2   2   2   2   184 194 194 194 194 194 194 186 2   2   2   2   2   2   2   2   2   2
2   2   2   2   2   2   2   2   2   2   2   2   2   2   2   2   2   2   184 194 194 194 194 194 194 186 2   2   2   2   2   2   2   2   2   2
2   2   2   2   2   2   2   2   2   2   2   2   2   2   2   2   2   2   184 194 194 194 194 194 194 186 2   2   2   2   2   2   2   2   2   2
2   2   2   2   2   2   2   2   2   2   2   2   2   2   2   2   2   2   184 194 194 194 194 194 194 186 2   2   2   2   2   2   2   2   2   2
2   2   2   2   2   2   2   2   2   2   2   2   2   2   2   2   2   2   184 194 194 194 194 194 194 186 2   2   2   2   2   2   2   2   2   2
2   2   2   2   2   2   2   2   2   2   2   2   2   2   2   2   2   2   184 194 194 194 194 194 194 186 2   2   2   2   2   2   2   2   2   2
2   2   2   2   2   2   2   2   2   2   2   2   2   2   2   2   2   2   184 194 194 194 194 194 194 186 2   2   2   2   2   2   2   2   2   2
2   2   2   2   2   2   2   2   2   2   2   2   2   2   2   2   2   2   184 194 194 194 194 194 194 186 2   2   2   2   2   2   2   2   2   2
2   2   2   2   2   2   2   2   2   2   2   2   2   2   2   2   2   2   184 194 194 194 194 194 194 186 2   2   2   2   2   2   2   2   2   2
2   2   2   2   2   2   2   2   2   2   2   2   2   2   2   2   2   2   2   2   2   2   2   2   2   2   2   2   2   2   2   2   2   2   2   2
2   2   2   2   2   2   2   2   2   2   2   2   2   2   2   2   2   2   2   2   2   2   2   2   2   2   2   2   2   2   2   2   2   2   2   2
2   2   2   2   2   2   2   2   2   2   2   2   2   2   2   2   2   2   2   2   2   2   2   2   2   2   2   2   2   2   2   2   2   2   2   2
2   2   2   2   2   2   2   2   2   2   2   2   2   2   2   2   2   2   2   2   2   2   2   2   2   2   2   2   2   2   2   2   2   2   2   2