35 45
1 1
9
0 0
2   181 188 188 188 188 188 188 188 188 188 188 188 188 188 188 188 188 188 188 188 188 188 188 188 188 188 188 188 188 188 188 188 183 2
2   186 170 170 170 170 170 170 170 170 170 170 170 170 170 170 170 170 170 170 170 170 170 170 170 170 170 170 170 170 170 170 170 186 2
2   186 176 176 176 176 176 176 176 176 176 176 176 176 176 176 176 186 176 176 176 176 176 176 176 176 176 176 176 176 176 176 176 186 2
2   186 191 191 191 191 191 191 191 191 191 191 191 191 191 191 191 186 191 191 191 191 191 191 191 191 191 191 191 191 191 191 191 186 2
2   186 191 191 191 191 191 191 191 191 191 191 191 191 191 191 191 186 191 191 191 191 191 191 191 191 191 191 191 191 191 191 191 186 2
2   186 191 191 191 191 191 191 191 191 191 191 191 191 191 191 191 186 191 191 191 191 191 191 191 191 191 191 191 191 191 191 191 186 2
2   186 191 191 191 191 191 191 191 191 191 191 191 191 191 191 191 186 191 191 191 191 191 191 191 191 191 191 191 191 191 191 191 186 2
2   186 191 191 191 191 191 191 191 191 191 191 191 191 191 191 191 186 191 191 191 191 191 191 191 191 191 191 191 191 191 191 191 186 2
2   187 188 191 188 188 188 188 188 186 191 191 191 188 188 188 188 188 191 191 191 188 188 188 188 186 188 188 188 188 188 191 188 189 2
2   2   2   1   2   2   2   2   2   186 191 191 191 170 170 170 170 170 191 191 191 170 170 170 170 186 2   2   2   2   2   1   2   2   2
2   2   2   2   2   2   2   2   2   186 191 191 191 176 176 176 176 176 191 191 191 176 176 176 176 186 2   2   2   2   2   2   2   2   2
2   2   2   2   2   2   2   2   2   186 191 191 191 191 191 191 191 191 191 191 191 191 191 191 191 186 2   2   2   2   2   2   2   2   2
2   2   2   2   2   2   2   2   188 188 191 191 191 191 191 191 191 191 191 191 191 191 191 191 191 188 188 2   2   2   2   2   2   2   2
2   2   2   2   2   2   2   2   170 170 191 191 191 186 191 191 191 191 191 191 191 186 191 191 191 170 170 2   2   2   2   2   2   2   2
2   2   2   2   2   2   2   2   176 176 191 191 191 186 191 191 191 191 191 191 191 186 191 191 191 176 176 2   2   2   2   2   2   2   2
2   2   2   2   2   2   2   1   191 191 191 191 191 186 191 191 191 191 191 191 191 186 191 191 191 191 191 1   2   2   2   2   2   2   2
2   2   2   2   2   2   2   2   188 186 191 191 191 186 191 191 191 191 191 191 191 186 191 191 191 186 188 2   2   2   2   2   2   2   2
2   2   2   2   2   2   2   2   2   186 191 191 191 186 191 191 191 191 191 191 191 186 191 191 191 186 2   2   2   2   2   2   2   2   2
2   2   2   2   2   2   2   2   2   186 191 191 191 186 191 191 191 191 191 191 191 186 191 191 191 186 2   2   2   2   2   2   2   2   2
2   2   2   2   2   2   2   2   2   186 191 191 191 176 191 191 191 191 191 191 191 176 191 191 191 186 2   2   2   2   2   2   2   2   2
2   2   2   2   2   2   2   2   188 188 191 191 191 191 191 191 191 191 191 191 191 191 191 191 191 188 188 2   2   2   2   2   2   2   2
2   2   2   2   2   2   2   2   170 170 191 191 191 186 191 191 191 191 191 191 191 186 191 191 191 170 170 2   2   2   2   2   2   2   2
2   2   2   2   2   2   2   2   176 176 191 191 191 186 191 191 191 191 191 191 191 186 191 191 191 176 176 2   2   2   2   2   2   2   2
2   2   2   2   2   2   2   1   191 191 191 191 191 186 191 191 191 191 191 191 191 186 191 191 191 191 191 1   2   2   2   2   2   2   2
2   2   2   2   2   2   2   2   188 186 191 191 191 186 191 191 191 191 191 191 191 186 191 191 191 186 188 2   2   2   2   2   2   2   2
2   2   2   2   2   2   2   2   2   186 191 191 191 186 191 191 191 191 191 191 191 186 191 191 191 186 2   2   2   2   2   2   2   2   2
2   2   2   2   2   2   2   2   2   186 191 191 191 186 191 191 191 191 191 191 191 186 191 191 191 186 2   2   2   2   2   2   2   2   2
2   2   2   2   2   2   2   2   2   186 191 191 191 176 191 191 191 191 191 191 191 176 191 191 191 186 2   2   2   2   2   2   2   2   2
2   2   2   2   2   2   2   2   188 188 191 191 191 191 191 191 191 191 191 191 191 191 191 191 191 188 188 2   2   2   2   2   2   2   2
2   2   2   2   2   2   2   2   170 170 191 191 191 191 191 191 191 186 191 191 191 191 191 191 191 170 170 2   2   2   2   2   2   2   2
2   2   2   2   2   2   2   2   176 176 191 191 191 191 191 191 191 186 191 191 191 191 191 191 191 176 176 2   2   2   2   2   2   2   2
2   2   2   2   2   2   2   1   191 191 191 191 191 191 191 191 191 186 191 191 191 191 191 191 191 191 191 1   2   2   2   2   2   2   2
2   2   2   2   2   2   2   2   188 186 191 191 191 191 191 191 191 186 191 191 191 191 191 191 191 186 188 2   2   2   2   2   2   2   2
2   2   2   2   2   2   2   2   2   186 191 191 191 188 188 188 188 186 188 188 188 188 191 191 191 186 2   2   2   2   2   2   2   2   2
2   2   2   2   2   2   2   2   2   186 191 191 191 170 170 170 170 186 170 170 170 170 191 191 191 186 2   2   2   2   2   2   2   2   2
2   2   2   2   2   2   2   2   2   186 191 191 191 176 176 176 176 186 176 176 176 176 191 191 191 186 2   2   2   2   2   2   2   2   2
2   181 188 188 188 188 188 188 188 188 191 191 191 191 191 191 191 186 191 191 191 191 191 191 191 188 188 188 188 188 188 188 188 183 2
2   186 170 170 170 170 170 170 170 170 191 191 191 191 191 191 191 186 191 191 191 191 191 191 191 170 170 170 170 170 170 170 170 186 2
2   186 176 176 176 176 176 176 176 176 191 191 191 191 191 191 191 170 191 191 191 191 191 191 191 176 176 176 176 176 176 176 176 186 2
2   170 191 191 191 191 191 191 191 191 191 191 191 191 191 191 191 176 191 191 191 191 191 191 191 191 191 191 191 191 191 191 191 170 2
2   176 191 191 191 191 191 191 191 191 191 191 191 191 191 191 191 191 191 191 191 191 191 191 191 191 191 191 191 191 191 191 191 176 2
1   191 191 191 191 191 191 191 191 191 191 191 191 191 191 191 191 191 191 191 191 191 191 191 191 191 191 191 191 191 191 191 191 191 1
2   186 191 191 191 191 191 191 191 191 191 191 191 191 191 191 191 191 191 191 191 191 191 191 191 191 191 191 191 191 191 191 191 186 2
2   186 191 191 191 191 191 191 191 191 191 191 191 191 191 191 191 191 191 191 191 191 191 191 191 191 191 191 191 191 191 191 191 186 2
2   187 188 188 188 188 188 188 188 188 188 188 188 188 188 188 188 188 188 188 188 188 188 188 188 188 188 188 188 188 188 188 188 189 2
178 3 9
179 31 9
180 7 15
181 7 23
182 7 31
183 27 15
184 27 23
186 0 41
187 34 41