16 19
11 12
3
0
1.1 1
1	1	1	1	1	1	1	1	1	1	1	1	1	1	1	1
1	1	1	1	1	1	1	1	1	1	1	1	1	1	1	1
1	1	1	1	1	1	1	1	1	1	1	1	1	1	1	1
1	1	1	16	16	16	16	16	16	16	16	16	1	1	1	1
1	1	1	16	17	17	17	17	17	17	17	16	1	1	1	1
1	1	1	16	17	17	17	17	17	17	17	16	1	1	1	1
1	1	1	16	17	17	17	17	17	17	17	16	1	1	1	1
1	1	1	16	27	27	27	27	27	27	27	16	1	1	1	1
1	1	1	16	27	27	27	27	27	27	27	16	1	1	1	1
1	1	1	16	27	27	27	27	27	27	27	17	1	1	1	1
1	1	1	16	27	27	27	27	27	27	27	17	1	1	1	1
1	1	1	16	27	27	27	27	27	27	27	17	1	1	1	1
1	1	1	16	27	27	27	27	27	27	27	27	0	1	1	1
1	1	1	16	27	27	27	27	27	27	27	16	1	1	1	1
1	1	1	16	27	27	27	27	27	27	27	16	1	1	1	1
1	1	1	16	16	16	16	27	16	16	16	16	1	1	1	1
1	1	1	1	1	1	1	0	1	1	1	1	1	1	1	1
1	1	1	1	1	1	1	1	1	1	1	1	1	1	1	1
1	1	1	1	1	1	1	1	1	1	1	1	1	1	1	1
173 12 12
174 7 16
246 8 14
22 10
3