14 27
12 15
0
0 0
188 188 188 188 188 188 188 188 188 188 188 188 188 188 188 188 188 188 188 188 188 188 188 188 188 188 188 188 188 183 2
170 170 170 170 170 170 170 170 170 170 170 170 170 170 170 170 170 170 170 170 170 170 170 170 170 170 170 170 170 170 2
176 176 176 176 176 176 176 176 176 176 176 176 176 176 176 176 176 176 176 176 176 176 176 176 176 176 176 176 176 176 2
191 191 191 191 191 191 191 191 191 191 191 191 191 191 191 191 191 191 191 191 191 191 191 191 191 191 191 191 191 184 2
191 191 191 191 191 191 191 191 191 191 191 191 191 191 191 191 191 191 191 191 191 191 191 191 191 191 191 191 191 184 2
191 191 191 191 191 191 191 191 191 191 191 191 191 191 191 191 191 191 191 191 191 191 191 191 191 191 191 191 191 184 2
191 191 191 191 183 191 191 191 181 188 188 191 188 188 183 191 191 191 181 188 188 191 188 188 183 191 191 191 191 184 2
2   2   2   2   186 191 191 191 184 2   2   1   2   2   186 191 191 191 184 2   2   1   2   2   186 191 191 191 191 184 2
2   2   2   2   186 191 191 191 184 2   2   2   2   2   186 191 191 191 184 2   2   2   2   2   186 191 191 191 191 184 2
2   2   2   2   186 191 191 191 184 2   2   2   2   2   186 191 191 191 184 2   2   2   2   2   186 191 191 191 191 184 2
2   2   2   2   186 191 191 191 184 2   2   2   2   2   186 191 191 191 184 2   2   2   2   2   186 191 191 191 191 184 2
2   2   2   2   186 191 191 191 184 2   2   2   2   2   186 191 191 191 184 2   2   2   2   2   186 191 191 191 191 170 2
2   2   2   2   186 191 191 191 184 2   2   2   2   2   186 191 191 191 184 2   2   2   2   2   186 191 191 191 191 176 2
2   2   2   2   186 191 191 191 184 2   2   2   2   2   186 191 191 191 184 2   2   2   2   2   186 191 191 191 191 191 1
2   2   2   2   186 191 191 191 184 2   2   2   2   2   186 191 191 191 184 2   2   2   2   2   186 191 191 191 191 184 2
2   2   2   2   188 191 191 191 184 2   2   2   2   2   188 191 191 191 184 2   2   2   2   2   187 188 188 188 188 189 2
2   2   2   2   188 191 191 191 184 2   2   2   2   2   188 191 191 191 184 2   2   2   2   2   2   2   2   2   2   2   2
2   2   188 188 186 191 191 191 187 188 188 188 188 188 183 191 191 191 184 2   2   2   2   2   2   2   2   2   2   2   2
2   2   170 170 170 191 191 191 170 170 170 170 170 170 170 191 191 191 184 2   2   2   2   2   2   2   2   2   2   2   2
2   2   176 176 176 191 191 191 176 176 176 176 176 176 176 191 191 191 184 2   2   2   2   2   2   2   2   2   2   2   2
2   2   191 191 191 191 191 191 191 191 191 191 191 191 191 191 191 191 184 2   2   2   2   2   2   2   2   2   2   2   2
2   2   191 191 191 191 191 191 191 191 191 191 191 191 191 191 191 191 184 2   2   2   2   2   2   2   2   2   2   2   2
2   2   191 191 191 191 191 191 191 191 191 191 191 191 191 191 191 191 184 2   2   2   2   2   2   2   2   2   2   2   2
2   2   188 188 183 191 191 191 181 188 188 188 188 188 183 191 191 191 184 2   2   2   2   2   181 188 188 188 188 183 2
2   2   2   2   188 191 191 191 184 2   2   2   2   2   186 191 191 191 184 2   2   2   2   2   186 170 170 170 170 184 2
2   2   2   2   188 191 191 191 184 2   2   2   2   2   186 191 191 191 184 2   2   2   2   2   186 176 176 176 176 176 2
2   2   2   2   188 191 191 191 184 2   2   2   2   2   186 191 191 191 184 2   2   2   2   2   186 191 191 191 191 170 2
2   2   2   2   188 191 191 191 184 2   2   2   2   2   186 191 191 191 184 2   2   2   2   2   186 191 191 191 191 191 1
2   2   2   2   188 191 191 191 184 2   2   2   2   2   186 191 191 191 184 2   2   2   2   2   186 191 191 191 191 184 2
2   2   2   2   188 191 191 191 184 2   2   2   2   2   186 191 191 191 184 2   2   2   2   2   186 191 191 191 191 184 2
2   2   2   2   188 191 191 191 184 2   2   2   2   2   186 191 191 191 184 2   2   2   2   2   186 191 191 191 191 184 2
2   2   2   2   188 191 191 191 184 2   2   2   2   2   186 191 191 191 184 2   2   2   2   2   186 191 191 191 191 184 2
2   2   2   2   188 191 191 191 184 2   2   2   2   2   186 191 191 191 184 2   2   2   2   2   186 191 191 191 191 184 2
2   2   2   2   188 191 191 191 184 2   2   1   2   2   186 191 191 191 184 2   2   1   2   2   186 191 191 191 191 184 2
188 188 188 188 189 191 191 191 187 188 188 191 188 188 189 191 191 191 187 188 188 191 188 188 189 191 191 191 191 184 2
191 191 191 191 191 191 191 191 191 191 191 191 191 191 191 191 191 191 191 191 191 191 191 191 191 191 191 191 191 184 2
191 191 191 191 191 191 191 191 191 191 191 191 191 191 191 191 191 191 191 191 191 191 191 191 191 191 191 191 191 184 2
191 191 191 191 191 191 191 191 191 191 191 191 191 191 191 191 191 191 191 191 191 191 191 191 191 191 191 191 191 184 2
188 188 188 188 188 188 188 188 188 188 188 188 188 188 188 188 188 188 188 188 188 188 188 188 188 188 188 188 188 189 2