9 13
4 11
1
0
0 0
2   2   2   2   2   2   2   2   2  
181 188 188 188 188 188 188 188 183
186 170 170 170 170 170 170 170 184
186 176 176 176 176 176 176 176 184
186 191 191 191 191 191 191 191 184
186 191 191 191 191 191 191 191 184
186 191 191 191 191 191 191 191 184
186 191 191 191 191 191 191 191 184
186 191 191 191 191 191 191 191 184
186 191 191 191 191 191 191 191 184
186 191 191 191 191 191 191 191 184
187 188 188 188 191 188 188 188 189
2   2   2   2   1   2   2   2   2  
189 4 12
  