11 13
4 11
2
0
0 0
2   2   2   2   2   2   2   2   2   2   2 
2   181 188 188 188 188 188 188 188 183 2
2   186 170 170 170 170 170 170 170 184 2
2   186 176 176 176 176 176 176 176 184 2
2   186 191 191 191 191 191 191 191 184 2
2   170 191 191 191 191 191 191 191 170 2
2   176 191 191 191 191 191 191 191 176 2
1   191 191 191 191 191 191 191 191 191 1
2   186 191 191 191 191 191 191 191 184 2
2   186 191 191 191 191 191 191 191 184 2
2   186 191 191 191 191 191 191 191 184 2
2   187 188 188 188 188 188 188 188 189 2
2   2   2   2   2   2   2   2   2   2   2
205 10 7
206 0 7
  