16 14
12 15
0
0
0 0
2   2   2   2   2   2   2   2   2   2   2   2   2   2   2   2
2   2   2   2   2   2   2   2   2   2   2   2   2   2   2   2
2   2   2   2   2   181 182 182 182 182 182 182 183 2   2   2
2   2   2   2   2   186 170 170 170 170 170 170 184 2   2   2
2   2   2   2   2   186 176 176 176 176 176 176 184 2   2   2
2   2   2   1   1   186 191 191 191 191 191 191 184 2   2   2
2   2   186 192 192 186 191 191 191 191 191 191 194 2   2   2
2   2   186 192 192 170 191 191 191 191 191 191 194 2   2   2
2   2   186 192 192 176 191 191 191 191 191 191 194 2   2   2
2   2   186 191 191 191 191 191 191 191 191 191 194 2   2   2
2   2   186 191 191 191 191 191 191 191 191 196 184 2   2   2
2   2   186 191 191 191 191 191 191 191 191 196 196 2   2   2
2   2   186 191 191 191 191 191 191 191 191 196 196 196 2   2
2   2   187 188 188 191 188 188 188 188 188 188 196 196 1   2
2   2   2   2   2   1   2   2   2   2   2   2   2   196 1   2
2   2   2   2   2   2   2   2   2   2   2   2   2   2   1   2