39 55
5 12
42
0
0 0
1	1	1	1	1	1	1	1	1	1	1	1	1	1	1	1	1	1	1	1	1	1	1	1	1	1	1	1	1	1	1	1	1	1	1	1	1	1	1
1	1	1	1	1	1	1	1	1	1	1	1	1	1	1	1	1	1	1	1	1	1	1	1	1	1	1	1	1	1	1	1	1	1	1	1	1	1	1
1	1	1	1	1	1	1	1	1	1	1	1	1	1	1	1	1	1	1	1	1	1	1	1	1	1	1	1	1	1	1	1	1	1	1	1	1	1	1
1	1	1	16	16	16	16	16	16	16	16	16	16	16	16	16	16	16	16	16	16	16	16	16	16	16	16	16	16	16	16	16	16	16	16	16	1	1	1
1	1	1	16	17	17	17	17	17	17	17	17	17	17	17	17	17	17	17	16	17	17	17	17	17	17	17	17	17	17	17	17	17	17	17	16	1	1	1
1	1	1	16	17	17	17	17	17	17	17	17	17	17	17	17	17	17	17	16	17	17	17	17	17	17	17	17	17	17	17	17	17	17	17	16	1	1	1
1	1	1	16	17	17	17	17	17	17	17	17	17	17	17	17	17	17	17	16	17	17	17	17	17	17	17	17	17	17	17	17	17	17	17	16	1	1	1
1	1	1	16	27	27	27	27	27	27	27	27	27	27	27	27	27	27	27	16	27	27	27	27	27	27	27	27	27	27	27	27	27	27	27	16	1	1	1
1	1	1	16	27	27	27	27	27	27	27	27	27	27	27	27	27	27	27	16	27	27	27	27	27	27	27	27	27	27	27	27	27	27	27	16	1	1	1
1	1	1	16	27	27	27	27	27	27	27	27	27	27	27	27	27	27	27	16	27	27	27	27	27	27	27	27	27	27	27	27	27	27	27	16	1	1	1
1	1	1	16	27	27	27	27	27	27	27	27	27	27	27	27	27	27	27	16	27	27	27	27	27	27	27	27	27	27	27	27	27	27	27	16	1	1	1
1	1	1	16	27	27	27	27	27	27	27	27	27	27	27	27	27	27	27	16	27	27	27	27	27	27	27	27	27	27	27	27	27	27	27	16	1	1	1
1	1	1	16	16	27	16	16	16	16	16	16	27	27	27	16	16	16	16	16	27	27	27	16	16	16	16	16	16	16	16	16	16	27	16	16	1	1	1
1	1	1	1	1	0	1	1	1	1	1	16	27	27	27	17	17	17	17	17	27	27	27	17	17	17	17	16	1	1	1	1	1	0	1	1	1	1	1
1	1	1	1	1	1	1	1	1	1	1	16	27	27	27	17	17	17	17	17	27	27	27	17	17	17	17	16	1	1	1	1	1	1	1	1	1	1	1
1	1	1	1	1	1	1	1	1	1	1	16	27	27	27	17	17	17	17	17	27	27	27	17	17	17	17	16	1	1	1	1	1	1	1	1	1	1	1
1	1	1	1	1	1	1	1	1	1	1	16	27	27	27	27	27	27	27	27	27	27	27	27	27	27	27	16	1	1	1	1	1	1	1	1	1	1	1
1	1	1	1	1	1	1	1	1	1	16	16	27	27	27	27	27	27	27	27	27	27	27	27	27	27	27	16	16	1	1	1	1	1	1	1	1	1	1
1	1	1	1	1	1	1	1	1	1	17	17	27	27	27	16	27	27	27	27	27	27	27	16	27	27	27	17	17	1	1	1	1	1	1	1	1	1	1
1	1	1	1	1	1	1	1	1	1	17	17	27	27	27	16	27	27	27	27	27	27	27	16	27	27	27	17	17	1	1	1	1	1	1	1	1	1	1
1	1	1	1	1	1	1	1	1	1	17	17	27	27	27	16	27	27	27	27	27	27	27	16	27	27	27	17	17	1	1	1	1	1	1	1	1	1	1
1	1	1	1	1	1	1	1	1	0	27	27	27	27	27	16	27	27	27	27	27	27	27	16	27	27	27	27	27	0	1	1	1	1	1	1	1	1	1
1	1	1	1	1	1	1	1	1	1	16	16	27	27	27	16	27	27	27	27	27	27	27	16	27	27	27	16	16	1	1	1	1	1	1	1	1	1	1
1	1	1	1	1	1	1	1	1	1	1	16	27	27	27	16	27	27	27	27	27	27	27	16	27	27	27	16	1	1	1	1	1	1	1	1	1	1	1
1	1	1	1	1	1	1	1	1	1	1	16	27	27	27	17	27	27	27	27	27	27	27	17	27	27	27	16	1	1	1	1	1	1	1	1	1	1	1
1	1	1	1	1	1	1	1	1	1	16	16	27	27	27	27	27	27	27	27	27	27	27	27	27	27	27	16	16	1	1	1	1	1	1	1	1	1	1
1	1	1	1	1	1	1	1	1	1	17	17	27	27	27	16	27	27	27	27	27	27	27	16	27	27	27	17	17	1	1	1	1	1	1	1	1	1	1
1	1	1	1	1	1	1	1	1	1	17	17	27	27	27	16	27	27	27	27	27	27	27	16	27	27	27	17	17	1	1	1	1	1	1	1	1	1	1
1	1	1	1	1	1	1	1	1	1	17	17	27	27	27	16	27	27	27	27	27	27	27	16	27	27	27	17	17	1	1	1	1	1	1	1	1	1	1
1	1	1	1	1	1	1	1	1	0	27	27	27	27	27	16	27	27	27	27	27	27	27	16	27	27	27	27	27	0	1	1	1	1	1	1	1	1	1
1	1	1	1	1	1	1	1	1	1	16	16	27	27	27	16	27	27	27	27	27	27	27	16	27	27	27	16	16	1	1	1	1	1	1	1	1	1	1
1	1	1	1	1	1	1	1	1	1	1	16	27	27	27	16	27	27	27	27	27	27	27	16	27	27	27	16	1	1	1	1	1	1	1	1	1	1	1
1	1	1	1	1	1	1	1	1	1	1	16	27	27	27	17	27	27	27	27	27	27	27	17	27	27	27	16	1	1	1	1	1	1	1	1	1	1	1
1	1	1	1	1	1	1	1	1	1	16	16	27	27	27	27	27	27	27	27	27	27	27	27	27	27	27	16	16	1	1	1	1	1	1	1	1	1	1
1	1	1	1	1	1	1	1	1	1	17	17	27	27	27	27	27	27	27	16	27	27	27	27	27	27	27	17	17	1	1	1	1	1	1	1	1	1	1
1	1	1	1	1	1	1	1	1	1	17	17	27	27	27	27	27	27	27	16	27	27	27	27	27	27	27	17	17	1	1	1	1	1	1	1	1	1	1
1	1	1	1	1	1	1	1	1	1	17	17	27	27	27	27	27	27	27	16	27	27	27	27	27	27	27	17	17	1	1	1	1	1	1	1	1	1	1
1	1	1	1	1	1	1	1	1	0	27	27	27	27	27	27	27	27	27	16	27	27	27	27	27	27	27	27	27	0	1	1	1	1	1	1	1	1	1
1	1	1	1	1	1	1	1	1	1	16	16	27	27	27	16	16	16	16	16	16	16	16	16	27	27	27	16	16	1	1	1	1	1	1	1	1	1	1
1	1	1	1	1	1	1	1	1	1	1	16	27	27	27	17	17	17	17	16	17	17	17	17	27	27	27	16	1	1	1	1	1	1	1	1	1	1	1
1	1	1	1	1	1	1	1	1	1	1	16	27	27	27	27	27	27	27	16	27	27	27	27	27	27	27	16	1	1	1	1	1	1	1	1	1	1	1
1	1	1	1	1	1	1	1	1	1	1	16	27	27	27	27	27	27	27	16	27	27	27	27	27	27	27	16	1	1	1	1	1	1	1	1	1	1	1
1	1	1	1	16	16	16	16	16	16	16	16	27	27	27	27	27	27	27	16	27	27	27	27	27	27	27	16	16	16	16	16	16	16	16	1	1	1	1
1	1	1	1	16	17	17	17	17	17	17	17	27	27	27	27	27	27	27	17	27	27	27	27	27	27	27	17	17	17	17	17	17	17	16	1	1	1	1
1	1	1	1	16	17	17	17	17	17	17	17	27	27	27	27	27	27	27	27	27	27	27	27	27	27	27	17	17	17	17	17	17	17	16	1	1	1	1
1	1	1	1	16	0	17	17	17	17	17	17	27	27	27	27	27	27	27	27	27	27	27	27	27	27	27	17	17	17	17	17	17	0	16	1	1	1	1
1	1	1	1	16	27	27	27	27	27	27	27	27	27	27	27	27	27	27	27	27	27	27	27	27	27	27	27	27	27	27	27	27	27	16	1	1	1	1
1	1	1	1	16	27	27	27	27	27	27	27	27	27	27	27	27	27	27	27	27	27	27	27	27	27	27	27	27	27	27	27	27	27	16	1	1	1	1
1	1	1	1	16	27	27	27	27	27	27	27	27	27	27	27	27	27	27	27	27	27	27	27	27	27	27	27	27	27	27	27	27	27	16	1	1	1	1
1	1	1	1	16	27	27	27	27	27	27	27	27	27	27	27	27	27	27	27	27	27	27	27	27	27	27	27	27	27	27	27	27	27	16	1	1	1	1
1	1	1	1	16	27	27	27	27	27	27	27	27	27	27	27	27	27	27	27	27	27	27	27	27	27	27	27	27	27	27	27	27	27	16	1	1	1	1
1	1	1	1	16	16	16	16	16	16	16	16	16	16	16	16	16	16	16	16	16	16	16	16	16	16	16	16	16	16	16	16	16	16	16	1	1	1	1
1	1	1	1	1	1	1	1	1	1	1	1	1	1	1	1	1	1	1	1	1	1	1	1	1	1	1	1	1	1	1	1	1	1	1	1	1	1	1
1	1	1	1	1	1	1	1	1	1	1	1	1	1	1	1	1	1	1	1	1	1	1	1	1	1	1	1	1	1	1	1	1	1	1	1	1	1	1
1	1	1	1	1	1	1	1	1	1	1	1	1	1	1	1	1	1	1	1	1	1	1	1	1	1	1	1	1	1	1	1	1	1	1	1	1	1	1
153 5 13
154 33 13
155 29 21
156 29 29
157 29 37
158 9 21
159 9 29
160 9 37
161 5 45
162 33 45
126 13 20
101 14 20
126 13 23
101 14 23
126 13 28
101 14 28
126 13 31
101 14 31
126 16 20
101 17 20
126 16 23
101 17 23
126 16 28
101 17 28
126 16 31
101 17 31
126 21 20
101 22 20
126 21 23
101 22 23
126 21 28
101 22 28
126 21 31
101 22 31
126 24 20
101 25 20
126 24 23
101 25 23
126 24 28
101 25 28
126 24 31
101 25 31