21 18
4 8
4
2
0 0
1	1	1	1	1	1	1	1	1	1	1	1	1	1	1	1	1	1	1	1	1
1	1	1	1	1	1	1	1	1	1	1	1	1	1	1	1	1	1	1	1	1
1	1	1	1	1	1	1	1	1	1	1	1	1	1	1	1	1	1	1	1	1
1	1	1	1	1	16	16	16	16	16	16	16	16	16	16	16	16	1	1	1	1
1	1	1	1	16	16	17	17	17	17	17	17	17	17	17	17	17	1	1	1	1
1	1	1	1	17	17	17	17	17	17	17	17	17	17	17	17	17	1	1	1	1
1	1	1	1	17	17	17	17	0	17	17	17	0	17	17	17	17	1	1	1	1
1	1	1	1	17	17	27	27	27	27	27	27	27	27	27	27	27	0	1	1	1
1	1	1	0	27	27	27	27	27	27	27	27	27	27	27	16	16	1	1	1	1
1	1	1	1	16	16	27	27	27	27	27	27	27	27	27	16	1	1	1	1	1
1	1	1	1	1	16	27	27	27	27	27	27	27	27	27	16	1	1	1	1	1
1	1	1	1	1	16	27	27	27	27	27	27	27	27	27	16	1	1	1	1	1
1	1	1	1	1	16	27	27	27	27	27	27	27	27	27	16	1	1	1	1	1
1	1	1	1	1	16	27	27	27	27	27	27	27	27	27	16	1	1	1	1	1
1	1	1	1	1	16	16	16	16	16	16	16	16	16	16	16	1	1	1	1	1
1	1	1	1	1	1	1	1	1	1	1	1	1	1	1	1	1	1	1	1	1
1	1	1	1	1	1	1	1	1	1	1	1	1	1	1	1	1	1	1	1	1
1	1	1	1	1	1	1	1	1	1	1	1	1	1	1	1	1	1	1	1	1
136 3 8
137 8 6
137 12 6
138 17 7
86 256 160
86 384 160