16 14
12 15
0
0 0
1   2   2   2   2   2   2   2   2   2   2   2   2   2   2   2
1   196 2   2   2   2   2   2   2   2   2   2   2   2   2   2
1   196 196 182 182 182 182 182 182 182 182 182 183 2   2   2
2   196 196 196 191 191 191 191 191 191 191 191 184 2   2   2
2   2   196 196 191 191 191 191 191 191 191 191 194 2   2   2
2   2   186 196 191 191 191 191 191 191 191 191 194 2   2   2
2   2   186 191 191 191 191 191 191 191 191 191 194 2   2   2
2   2   186 191 191 191 191 191 191 191 191 191 194 2   2   2
2   2   186 191 191 191 191 191 191 191 191 196 184 2   2   2
2   2   186 191 191 191 191 191 191 191 191 196 196 2   2   2
2   2   186 191 191 191 191 191 191 191 191 196 196 196 2   2
2   2   187 188 188 191 188 188 188 188 188 188 196 196 1   2
2   2   2   2   2   1   2   2   2   2   2   2   2   196 1   2
2   2   2   2   2   2   2   2   2   2   2   2   2   2   1   2