32 54
12 15
3
0
0 0
2   2   2   2   2   2   2   2   2   2   2   2   2   2   2   2   2   2   2   2   2   2   2   2   2   2   2   2   2   2   2   2   
2   2   2   2   2   2   2   2   2   2   2   2   2   2   2   2   2   2   2   2   2   2   2   2   2   2   2   2   2   2   2   2   
2   2   2   2   2   2   2   2   2   2   2   2   2   2   2   2   2   2   2   2   2   2   2   2   2   2   2   2   2   2   2   2   
2   2   2   2   2   2   2   2   2   2   2   2   2   2   2   2   2   2   2   2   2   2   2   2   2   2   2   2   2   2   2   2   
2   2   2   2   2   2   2   2   2   2   2   2   2   2   2   2   2   2   2   2   2   2   2   2   2   2   2   2   2   2   2   2   
2   2   2   2   2   2   2   2   2   2   2   2   2   2   181 182 182 182 182 182 182 182 182 183 2   2   2   2   2   2   2   2   
2   2   2   2   2   2   2   2   2   2   2   2   2   2   184 170 170 170 170 170 170 170 170 188 188 2   2   2   2   2   2   2  
2   2   2   2   2   2   2   2   2   2   2   2   2   2   184 176 176 1   176 176 176 176 176 170 170 2   2   2   2   2   2   2   
2   2   2   2   2   2   2   2   2   2   2   2   2   2   184 191 191 191 191 191 191 191 191 176 173 2   2   2   2   2   2   2   
2   2   2   2   2   2   2   2   2   2   2   2   2   2   184 191 191 191 191 191 191 191 191 196 176 2   2   2   2   2   2   2   
2   2   2   2   2   2   2   2   2   2   2   2   2   2   184 191 191 191 191 191 191 191 191 196 196 2   2   2   2   2   2   2  
2   188 188 188 188 188 188 188 188 188 188 188 188 188 189 191 191 191 191 191 191 191 191 196 196 196 1   2   2   2   2   2  
2   170 170 170 170 170 170 170 170 170 170 170 170 170 170 191 191 191 191 191 191 191 191 181 196 196 1   2   2   2   2   2   
2   173 173 176 176 1   176 176 176 1   176 176 176 176 176 191 191 191 191 191 191 187 188 186 170 196 1   2   2   2   2   2   
2   173 176 195 191 191 191 191 191 191 191 191 191 191 191 191 191 191 191 191 191 170 170 186 173 2   2   2   2   2   2   2   
2   176 195 195 191 191 191 191 191 191 191 191 191 191 191 191 191 191 191 191 191 173 173 186 176 2   2   2   2   2   2   2   
1   195 195 195 191 191 191 191 191 191 191 191 191 191 191 191 191 191 191 191 191 173 173 186 2   2   2   2   2   2   2   2   
1   195 195 188 188 188 188 188 188 188 188 188 188 188 182 191 191 191 191 191 191 176 176 186 2   2   2   2   2   2   2   2   
1   195 2   2   2   2   2   2   2   2   2   2   2   2   184 191 191 191 191 191 191 191 191 186 2   2   2   2   2   2   2   2   
2   2   2   2   2   2   2   2   2   2   2   2   2   2   184 191 191 191 191 191 191 191 191 186 2   2   2   2   2   2   2   2  
2   2   2   2   2   2   2   2   2   2   2   2   2   2   184 191 191 191 191 191 191 191 191 186 2   2   2   2   2   2   2   2   
2   2   2   2   2   2   2   2   2   2   2   2   2   2   184 191 191 191 191 191 191 191 191 186 2   2   2   2   2   2   2   2   
2   2   2   2   2   2   2   2   2   2   2   2   2   2   184 191 191 191 191 191 191 191 191 186 2   2   2   2   2   2   2   2   
2   2   2   2   2   2   2   2   2   2   2   2   2   2   184 191 191 191 191 191 191 191 191 186 2   2   2   2   2   2   2   2   
2   2   2   2   2   2   2   2   2   2   2   2   2   2   184 191 191 191 191 191 191 191 191 186 2   2   2   2   2   2   2   2   
2   2   2   2   2   2   2   2   2   2   2   2   2   2   184 191 191 191 191 191 191 191 191 186 2   2   2   2   2   2   2   2   
2   2   2   2   2   2   2   2   2   2   2   2   2   2   184 191 191 191 191 191 191 191 191 186 2   2   2   2   2   2   2   2   
2   2   2   2   2   2   2   2   2   2   2   2   2   2   187 188 188 188 183 191 191 191 181 189 2   2   2   2   2   2   2   2   
2   2   2   2   2   2   2   2   2   2   2   2   2   2   2   2   2   2   184 191 191 191 186 2   2   2   2   2   2   2   2   2  
2   2   2   2   2   2   2   2   2   2   2   2   2   2   2   2   2   2   184 191 191 191 186 2   2   2   2   2   2   2   2   2  
2   2   2   2   2   2   2   2   2   2   2   2   2   2   2   2   2   2   184 191 191 191 186 2   2   2   2   2   2   2   2   2  
2   2   2   2   2   2   2   2   2   2   2   2   2   2   2   2   2   2   184 191 191 191 186 2   2   2   2   2   2   2   2   2  
2   2   2   2   2   2   2   2   2   2   2   2   2   2   2   2   2   2   184 191 191 191 186 2   2   2   2   2   2   2   2   2  
2   2   2   2   2   2   2   2   2   2   2   2   2   2   2   2   2   2   184 191 191 191 186 2   2   2   2   2   2   2   2   2  
2   2   2   2   2   2   2   2   2   2   2   2   2   2   2   2   2   2   184 191 191 191 186 2   2   2   2   2   2   2   2   2  
2   2   2   2   2   2   2   2   2   2   2   2   2   2   2   2   2   2   184 191 191 191 186 2   2   2   2   2   2   2   2   2  
2   2   2   2   2   2   2   2   2   2   2   2   2   2   2   2   2   2   184 191 191 191 186 2   2   2   2   2   2   2   2   2  
2   2   2   2   2   2   2   2   2   2   2   2   181 188 188 188 188 188 189 191 191 191 187 188 183 2   2   2   2   2   2   2   
2   2   2   2   2   2   2   2   2   2   2   2   184 170 170 170 170 170 170 191 191 191 170 170 186 2   2   2   2   2   2   2    
2   2   2   2   2   2   2   2   2   2   2   2   184 176 176 176 176 176 176 191 191 191 176 176 186 2   2   2   2   2   2   2   
2   2   2   2   2   2   2   2   2   2   2   2   184 191 191 191 191 191 191 191 191 191 191 191 186 2   2   2   2   2   2   2   
2   2   2   2   2   2   2   2   2   2   2   2   184 191 191 191 191 191 191 191 191 191 191 191 186 2   2   2   2   2   2   2   
2   2   2   2   2   2   2   2   2   2   2   2   184 191 191 191 191 191 191 191 191 191 191 191 186 2   2   2   2   2   2   2   
2   2   2   2   2   2   2   2   2   2   2   2   184 191 191 191 191 191 191 191 191 191 191 191 186 2   2   2   2   2   2   2  
2   2   2   2   2   2   2   2   2   2   2   2   184 191 191 191 191 191 191 191 191 191 191 191 186 2   2   2   2   2   2   2   
2   2   2   2   2   2   2   2   2   2   2   2   184 191 191 191 191 191 191 191 191 191 191 191 186 2   2   2   2   2   2   2   
2   2   2   2   2   2   2   2   2   2   2   2   184 191 191 191 181 188 188 188 188 188 188 188 189 2   2   2   2   2   2   2   
2   2   2   2   2   2   2   2   2   2   2   2   184 191 191 191 186 2   2   2   2   2   2   2   2   2   2   2   2   2   2   2   
2   2   2   2   2   2   2   2   2   2   2   2   184 191 191 191 186 2   2   2   2   2   2   2   2   2   2   2   2   2   2   2   
2   2   2   2   2   2   2   2   2   2   2   2   184 191 191 191 186 2   2   2   2   2   2   2   2   2   2   2   2   2   2   2   
2   2   2   2   2   2   2   2   2   2   2   2   187 188 188 188 189 2   2   2   2   2   2   2   2   2   2   2   2   2   2   2   
2   2   2   2   2   2   2   2   2   2   2   2   2   2   2   2   2   2   2   2   2   2   2   2   2   2   2   2   2   2   2   2   
2   2   2   2   2   2   2   2   2   2   2   2   2   2   2   2   2   2   2   2   2   2   2   2   2   2   2   2   2   2   2   2   
2   2   2   2   2   2   2   2   2   2   2   2   2   2   2   2   2   2   2   2   2   2   2   2   2   2   2   2   2   2   2   2   
235 26 11
235 26 12
235 26 13