15 13
1 9
3
0 0
2   2   2   2   2   2   2   2   2   2   2   2   2   2   2
2   2   126 133 133 133 133 133 133 133 133 133 128 2   2
2   2   131 115 115 115 115 115 115 115 115 115 131 2   2
2   2   131 121 121 121 121 121 121 121 121 121 131 2   2
2   2   131 191 191 191 191 191 191 191 191 191 131 2   2
2   2   131 191 191 191 191 191 191 191 191 191 131 2   2
2   126 134 191 191 191 191 191 191 191 191 191 132 128 2
2   115 115 191 191 191 191 191 191 191 191 191 115 115 2
2   121 121 191 191 191 191 191 191 191 191 191 121 121 2
1   191 191 191 191 191 191 191 191 191 191 191 191 191 1  
2   132 128 191 191 191 191 191 191 191 191 191 126 134 2
2   2   132 127 127 127 127 191 127 127 127 127 134 2   2
2   2   2   2   2   2   2   1   2   2   2   2   2   2   2
216 0 9
217 7 12
218 14 9
