34 33
29 17
10
15
0 0
1	1	1	1	1	1	1	1	1	1	1	1	1	1	1	1	1	1	1	1	1	1	1	1	1	1	1	1	1	1	1	1	1	1
1	1	1	1	1	1	1	1	1	1	1	1	1	1	1	1	1	1	1	1	1	1	1	1	1	1	1	1	1	1	1	1	1	1
1	1	1	1	1	1	1	1	1	1	1	1	1	1	1	1	1	1	1	1	1	1	1	1	1	1	1	1	1	1	1	1	1	1
1	1	1	1	1	1	1	1	1	1	1	1	16	16	16	16	16	16	16	16	16	16	16	16	16	16	16	16	16	16	1	1	1	1
1	1	1	1	1	1	1	1	1	1	1	1	17	17	17	17	17	17	17	17	17	17	17	17	17	17	16	17	17	16	1	1	1	1
1	1	1	1	1	1	1	1	1	1	1	1	17	17	17	17	17	17	17	17	17	17	17	17	17	17	16	17	17	16	1	1	1	1
1	1	1	1	1	1	1	1	1	1	1	1	17	17	17	17	17	17	17	17	17	17	17	17	17	17	16	17	17	16	1	1	1	1
1	1	1	1	1	1	1	1	1	1	1	0	21	17	17	17	17	17	17	17	17	17	17	17	17	17	16	17	17	16	1	1	1	1
1	1	1	1	1	1	1	1	1	1	1	0	21	21	17	17	17	17	17	17	17	17	17	17	17	17	16	17	17	16	1	1	1	1
1	1	1	16	16	16	16	16	16	16	1	1	1	21	21	27	27	27	27	27	27	27	27	27	27	27	16	17	17	16	1	1	1	1
1	1	1	16	17	17	17	17	17	16	1	1	1	1	21	27	27	27	27	27	27	27	27	27	27	27	16	17	17	16	1	1	1	1
1	1	1	16	17	17	17	17	17	16	1	1	1	1	16	27	27	27	27	27	27	27	27	27	27	27	16	17	17	16	1	1	1	1
1	1	1	16	17	17	17	17	17	16	1	1	16	16	16	16	16	16	18	18	16	16	16	16	16	16	16	17	17	16	1	1	1	1
1	1	1	16	27	27	27	27	27	16	1	1	16	17	17	17	17	17	18	18	17	17	17	17	17	17	17	17	17	16	1	1	1	1
1	1	1	16	27	27	27	27	27	16	1	1	16	17	17	17	17	17	18	18	17	17	17	17	17	17	17	17	17	17	1	1	1	1
1	1	1	16	27	27	27	27	27	16	1	1	16	17	17	17	17	17	18	18	17	17	17	17	17	17	17	17	17	17	1	1	1	1
1	1	1	16	27	27	27	27	27	16	16	16	16	27	27	27	27	27	27	27	27	27	27	27	27	27	27	27	27	17	1	1	1	1
1	1	1	16	27	27	27	27	27	17	17	17	17	27	27	27	27	27	27	27	27	27	27	27	27	27	27	27	27	27	0	1	1	1
1	1	1	16	27	27	27	27	27	17	17	17	17	27	27	27	27	27	27	27	27	27	27	27	27	27	27	27	27	16	1	1	1	1
1	1	1	16	27	27	27	27	27	17	17	17	17	27	27	27	27	27	27	27	27	27	27	27	27	27	27	27	27	16	1	1	1	1
1	1	1	16	27	27	27	27	27	27	27	27	27	27	27	27	27	27	27	27	27	27	27	27	27	27	27	27	27	16	1	1	1	1
1	1	1	16	27	27	27	27	27	27	27	27	27	27	27	27	27	27	27	27	27	27	27	27	27	27	27	27	27	16	1	1	1	1
1	1	1	16	27	27	27	27	27	27	27	27	27	27	27	27	27	27	27	27	27	27	27	27	27	27	27	27	27	16	1	1	1	1
1	1	1	16	27	27	27	27	27	27	27	27	27	27	27	27	27	27	27	27	27	27	27	27	27	27	27	27	27	16	1	1	1	1
1	1	1	16	27	27	27	27	27	27	27	27	27	27	27	27	27	27	27	27	16	16	16	16	16	16	16	16	16	16	1	1	1	1
1	1	1	16	27	27	27	27	27	27	27	27	27	27	27	27	27	27	27	27	16	1	1	1	1	1	1	1	1	1	1	1	1	1
1	1	1	16	27	27	27	27	27	27	27	27	27	27	27	27	27	27	27	27	16	1	1	1	1	1	1	1	1	1	1	1	1	1
1	1	1	16	27	27	27	27	27	27	27	27	27	27	27	27	27	27	27	27	16	1	1	1	1	1	1	1	1	1	1	1	1	1
1	1	1	16	27	27	27	27	27	27	27	27	27	27	27	27	27	27	27	27	16	1	1	1	1	1	1	1	1	1	1	1	1	1
1	1	1	16	16	16	16	16	16	16	16	16	16	16	16	16	16	16	16	16	16	1	1	1	1	1	1	1	1	1	1	1	1	1
1	1	1	1	1	1	1	1	1	1	1	1	1	1	1	1	1	1	1	1	1	1	1	1	1	1	1	1	1	1	1	1	1	1
1	1	1	1	1	1	1	1	1	1	1	1	1	1	1	1	1	1	1	1	1	1	1	1	1	1	1	1	1	1	1	1	1	1
1	1	1	1	1	1	1	1	1	1	1	1	1	1	1	1	1	1	1	1	1	1	1	1	1	1	1	1	1	1	1	1	1	1
183 30 17
184 6 12
185 25 8
186 11 7
186 11 8
186 11 9
213 18 16
213 19 16
249 17 9
250 18 27
36 384 192
36 416 224
36 448 256 
37 384 224
37 416 256
37 448 288
37 384 256
37 416 288
37 448 320
38 384 288
38 416 320
38 448 352
39 384 320
39 384 352
39 416 352