28 25
11 23
4
0 0
2   2   2   2   2   2   2   2   2   2   2   2   2   2   2   2   2   2   2   2   2   2   2   2   2   2   2   2
2   181 188 188 188 188 183 2   2   2   2   2   2   2   2   2   2   2   2   2   2   181 188 188 188 188 183 2
2   186 170 170 170 170 184 2   2   2   2   2   2   2   2   2   2   2   2   2   2   186 170 170 170 170 184 2
2   186 176 176 176 176 184 2   2   2   2   2   2   2   2   2   2   2   2   2   2   186 176 176 176 176 184 2
2   186 191 191 191 191 184 2   2   2   2   2   2   2   2   2   2   2   2   2   2   186 191 191 191 191 184 2
1   191 191 191 191 191 184 2   2   2   2   2   2   2   2   2   2   2   2   2   2   186 191 191 191 191 191 1
2   186 191 191 191 191 184 2   2   2   2   2   2   2   2   2   2   2   2   2   2   186 191 191 191 191 184 2
2   186 191 191 191 191 184 2   2   2   2   2   2   2   2   2   2   2   2   2   2   186 191 191 191 191 184 2
1   191 191 191 191 191 184 2   2   2   2   2   2   2   2   2   2   2   2   2   2   186 191 191 191 191 191 1
2   186 191 191 191 191 184 2   2   2   2   2   2   2   2   2   2   2   2   2   2   186 191 191 191 191 184 2
2   186 191 191 191 191 184 2   2   2   2   2   2   2   2   2   2   2   2   2   2   186 191 191 191 191 184 2
1   191 191 191 191 191 184 2   2   2   2   2   2   2   2   2   2   2   2   2   2   186 191 191 191 191 191 1
2   186 191 191 191 191 184 2   2   2   2   2   2   2   2   2   2   2   2   2   2   186 191 191 191 191 184 2
2   186 191 191 191 191 184 2   2   2   2   2   2   2   2   2   2   2   2   2   2   186 191 191 191 191 184 2
1   191 191 191 191 191 184 2   2   2   2   2   2   2   2   2   2   2   2   2   2   186 191 191 191 191 191 1
2   186 191 191 191 191 184 2   2   2   2   2   2   2   2   2   2   2   2   2   2   186 191 191 191 191 184 2
2   186 191 191 191 191 184 2   2   2   2   2   2   2   2   2   2   2   2   2   2   186 191 191 191 191 184 2
1   191 191 191 191 191 184 2   2   2   2   2   2   2   2   2   2   2   2   2   2   186 191 191 191 191 191 1
2   186 191 191 191 191 184 2   2   2   2   2   2   2   2   2   2   2   2   2   2   186 191 191 191 191 184 2
2   186 191 191 191 191 184 2   2   2   2   2   2   2   2   2   2   2   2   2   2   186 191 191 191 191 184 2
1   191 191 191 191 191 191 1   2   2   2   2   2   2   2   2   2   2   2   2   1   191 191 191 191 191 191 1
2   186 191 191 191 191 184 2   2   2   2   2   2   2   2   2   2   2   2   2   2   186 191 191 191 191 184 2
2   186 191 191 191 191 184 2   2   2   2   2   2   2   2   2   2   2   2   2   2   186 191 191 191 191 184 2
2   187 188 188 188 188 189 2   2   2   2   2   2   2   2   2   2   2   2   2   2   187 188 188 188 188 189 2
2   2   2   2   2   2   2   2   2   2   2   2   2   2   2   2   2   2   2   2   2   2   2   2   2   2   2   2
188 27 5
189 0 5
190 7 20
191 20 20


