28 28
23 9
8
0
0 0
1	1	1	1	1	1	1	1	1	1	1	1	1	1	1	1	1	1	1	1	1	1	1	1	1	1	1	1
1	1	1	1	1	1	1	1	1	1	1	1	1	1	1	1	1	1	1	1	1	1	1	1	1	1	1	1
1	1	1	1	1	1	1	1	1	1	1	1	1	1	1	1	1	1	1	1	1	1	1	1	1	1	1	1
1	1	1	16	16	16	16	16	16	16	16	16	16	16	16	16	16	16	16	16	16	16	16	16	1	1	1	1
1	1	1	16	17	17	17	17	17	17	17	17	17	17	17	17	17	17	17	17	17	17	17	16	1	1	1	1
1	1	1	16	17	17	17	17	17	17	17	17	17	17	17	17	17	17	17	17	17	17	17	16	1	1	1	1
1	1	1	16	17	17	17	17	17	17	17	17	17	17	17	17	17	17	17	17	17	17	17	17	1	1	1	1
1	1	1	16	27	27	27	27	27	27	27	27	27	27	27	27	27	27	27	27	27	27	27	17	1	1	1	1
1	1	1	16	27	27	27	27	27	27	27	27	27	27	27	27	27	27	27	27	27	27	27	17	1	1	1	1
1	1	1	16	27	27	27	27	27	27	27	27	27	27	27	27	27	27	27	27	27	27	27	27	0	1	1	1
1	1	1	16	27	27	27	27	27	27	27	27	27	27	27	27	27	27	27	27	27	27	27	16	1	1	1	1
1	1	1	16	27	27	27	27	27	27	27	27	27	27	27	27	27	27	27	27	27	27	27	16	1	1	1	1
1	1	1	16	16	27	16	16	16	16	16	16	16	16	16	16	16	16	16	16	16	16	16	16	1	1	1	1
1	1	1	1	1	0	1	1	1	1	1	1	16	17	17	17	17	17	17	17	17	17	17	16	1	1	1	1
1	1	1	1	1	1	1	1	1	1	1	1	16	17	17	17	17	17	17	17	17	17	17	17	1	1	1	1
1	1	1	1	1	1	1	1	1	1	1	1	16	17	17	17	17	17	17	17	17	17	17	17	1	1	1	1
1	1	1	1	1	1	1	1	1	1	1	1	16	27	27	27	27	0	27	27	27	27	27	17	1	1	1	1
1	1	1	1	1	1	1	1	1	1	1	1	16	27	27	27	27	27	27	27	27	27	27	27	0	1	1	1
1	1	1	1	1	1	1	1	1	1	1	1	16	27	27	27	27	27	27	27	27	27	27	16	1	1	1	1
1	1	1	1	1	1	1	1	1	1	1	1	16	27	27	27	27	27	27	16	16	27	16	16	1	1	1	1
1	1	1	1	1	1	1	1	1	1	1	1	16	27	27	27	27	27	27	16	1	0	1	1	1	1	1	1
1	1	1	1	1	1	1	1	1	1	1	1	16	27	27	27	27	27	27	16	1	1	1	1	1	1	1	1
1	1	1	1	1	1	1	1	1	1	1	1	16	27	27	27	27	27	27	16	1	1	1	1	1	1	1	1
1	1	1	1	1	1	1	1	1	1	1	1	16	27	27	27	27	27	27	16	1	1	1	1	1	1	1	1
1	1	1	1	1	1	1	1	1	1	1	1	16	16	16	16	16	16	16	16	1	1	1	1	1	1	1	1
1	1	1	1	1	1	1	1	1	1	1	1	1	1	1	1	1	1	1	1	1	1	1	1	1	1	1	1
1	1	1	1	1	1	1	1	1	1	1	1	1	1	1	1	1	1	1	1	1	1	1	1	1	1	1	1
1	1	1	1	1	1	1	1	1	1	1	1	1	1	1	1	1	1	1	1	1	1	1	1	1	1	1	1
178 24 9
179 5 13
180 17 16
181 24 17
209 14 18
210 15 18
210 14 17
210 15 17