21 19
10 14
11
14
1 2
1	1	1	1	1	1	1	1	1	1	1	1	1	1	1	1	1	1	1	1	1
1	1	1	1	1	1	1	1	1	1	1	1	1	1	1	1	1	1	1	1	1
1	1	1	1	1	1	1	1	1	1	1	1	1	1	1	1	1	1	1	1	1
1	1	1	1	1	1	16	16	16	16	16	16	16	16	16	16	1	1	1	1	1
1	1	1	1	1	1	17	17	17	17	17	17	17	17	17	17	1	1	1	1	1
1	1	1	1	1	1	17	17	17	17	17	17	17	17	17	17	1	0	1	1	1
1	1	1	1	1	1	17	17	17	17	17	17	17	17	17	17	20	0	1	1	1
1	1	1	1	1	1	27	27	27	27	27	27	27	27	27	20	1	1	1	1	1
1	1	1	1	1	20	27	27	27	27	27	27	27	27	27	16	1	1	1	1	1
1	1	1	0	20	1	16	27	27	27	27	27	27	27	27	16	1	1	1	1	1
1	1	1	0	1	1	16	27	27	27	27	27	27	27	27	16	1	1	1	1	1
1	1	1	1	1	1	16	27	27	27	27	27	27	27	27	16	1	1	1	1	1
1	1	1	1	1	1	16	27	27	27	27	27	27	27	27	16	1	1	1	1	1
1	1	1	1	1	1	16	27	27	27	27	27	27	27	27	16	1	1	1	1	1
1	1	1	1	1	1	16	16	16	16	27	16	16	16	16	16	1	1	1	1	1
1	1	1	1	1	1	1	1	1	1	0	1	1	1	1	1	1	1	1	1	1
1	1	1	1	1	1	1	1	1	1	1	1	1	1	1	1	1	1	1	1	1
1	1	1	1	1	1	1	1	1	1	1	1	1	1	1	1	1	1	1	1	1
1	1	1	1	1	1	1	1	1	1	1	1	1	1	1	1	1	1	1	1	1
187 10 15
188 10 6
189 3 9
189 3 10
190 17 5
190 17 6
213 6 7
213 6 8
213 14 7
213 14 8
248 14 9
32 128 256
32 160 224
32 480 192
32 512 160
33 128 288
33 160 256
33 480 224
33 512 192
34 128 320
34 160 288
34 480 256
34 512 224
35 160 320
35 512 256
23 20
17 5