20 33
4 8
3
0
1 1
1	1	1	1	1	1	1	1	1	1	1	1	1	1	1	1	1	1	1	1
1	1	1	1	1	1	1	1	1	1	1	1	1	1	1	1	1	1	1	1
1	1	1	1	1	1	1	1	1	1	1	1	1	1	1	1	1	1	1	1
1	1	1	1	16	16	16	16	16	1	1	1	1	1	1	1	1	1	1	1
1	1	1	1	16	17	17	17	16	1	1	1	1	1	1	1	1	1	1	1
1	1	1	1	17	17	17	17	16	1	1	1	1	1	1	1	1	1	1	1
1	1	1	1	17	17	17	17	16	1	1	1	1	1	1	1	1	1	1	1
1	1	1	1	17	27	27	27	16	1	1	1	1	1	1	1	1	1	1	1
1	1	1	0	27	27	27	27	16	1	1	1	1	1	1	1	1	1	1	1
1	1	1	1	16	27	27	27	16	1	16	16	16	16	16	1	1	1	1	1
1	1	1	1	16	27	27	27	16	16	16	17	17	17	16	16	1	1	1	1
1	1	1	1	16	27	27	27	16	16	17	17	17	17	17	16	16	1	1	1
1	1	1	1	16	27	27	27	17	17	17	17	0	17	17	17	16	1	1	1
1	1	1	1	16	27	27	27	17	17	17	27	27	27	17	17	16	1	1	1
1	1	1	1	16	27	27	27	17	17	27	27	27	27	27	17	16	1	1	1
1	1	1	1	16	27	27	27	27	27	27	16	16	16	27	27	16	1	1	1
1	1	1	1	16	16	16	16	16	16	16	16	16	16	16	27	16	1	1	1
1	1	1	1	16	17	17	17	17	17	17	16	16	16	17	27	16	1	1	1
1	1	1	1	16	17	17	17	17	17	17	17	17	17	17	27	16	1	1	1
1	1	1	1	16	17	17	17	17	17	17	17	17	17	17	27	16	1	1	1
1	1	1	1	16	27	27	27	27	27	27	17	17	17	27	27	16	1	1	1
1	1	1	1	16	27	27	27	16	16	27	27	27	27	27	16	16	1	1	1
1	1	1	1	16	27	27	27	16	16	16	27	27	27	16	16	1	1	1	1
1	1	1	1	16	27	27	27	16	1	16	16	16	16	16	1	1	1	1	1
1	1	1	1	17	27	27	27	16	1	1	1	1	1	1	1	1	1	1	1
1	1	1	1	17	27	27	27	16	1	1	1	1	1	1	1	1	1	1	1
1	1	1	1	17	27	27	27	16	1	1	1	1	1	1	1	1	1	1	1
1	1	1	0	27	27	27	27	16	1	1	1	1	1	1	1	1	1	1	1
1	1	1	1	16	27	27	27	16	1	1	1	1	1	1	1	1	1	1	1
1	1	1	1	16	16	16	16	16	1	1	1	1	1	1	1	1	1	1	1
1	1	1	1	1	1	1	1	1	1	1	1	1	1	1	1	1	1	1	1
1	1	1	1	1	1	1	1	1	1	1	1	1	1	1	1	1	1	1	1
1	1	1	1	1	1	1	1	1	1	1	1	1	1	1	1	1	1	1	1
163 3 8
164 3 27
165 12 12
14 10