57 55
31 39
5
0
0.7 2
1	1	1	1	1	1	1	1	1	1	1	1	1	1	1	1	1	1	1	1	1	1	1	1	1	1	1	1	1	1	1	1	1	1	1	1	1	1	1	1	1	1	1	1	1	1	1	1	1	1	1	1	1	1	1	1	1
1	1	1	1	1	1	1	1	1	1	1	1	1	1	1	1	1	1	1	1	1	1	1	1	1	1	1	1	1	1	1	1	1	1	1	1	1	1	1	1	1	1	1	1	1	1	1	1	1	1	1	1	1	1	1	1	1
1	1	1	1	1	1	1	1	1	1	1	1	1	1	1	1	1	1	1	1	1	1	1	1	1	1	1	1	1	1	1	1	1	1	1	1	1	1	1	1	1	1	1	1	1	1	1	1	1	1	1	1	1	1	1	1	1
1	1	1	1	16	17	17	17	17	17	17	17	17	17	17	17	17	17	17	17	17	17	17	17	17	17	17	17	17	17	17	17	17	17	17	17	17	17	17	17	17	17	17	17	17	17	17	17	17	17	17	17	17	17	1	1	1
1	1	1	1	16	17	17	17	17	17	17	17	17	17	17	17	17	17	17	17	17	17	17	17	17	17	17	17	17	17	17	17	17	17	17	17	17	17	17	17	17	17	17	17	17	17	17	17	17	17	17	17	17	17	1	1	1
1	1	1	1	16	17	17	17	17	17	17	17	17	17	17	17	17	17	17	17	17	17	17	17	17	17	17	17	17	17	17	17	17	17	17	17	17	17	17	17	17	17	17	17	17	17	17	17	17	17	17	17	17	17	1	1	1
1	1	1	1	16	17	17	17	17	17	17	17	17	17	17	17	17	17	17	17	17	17	17	17	17	17	17	17	17	17	17	17	17	17	17	17	17	17	17	17	17	17	17	17	17	17	17	17	17	17	17	17	17	17	1	1	1
1	1	1	1	16	17	17	17	17	17	17	17	17	17	17	17	17	17	17	17	17	17	17	17	17	17	17	17	17	17	17	17	17	17	17	17	17	17	17	17	17	17	17	17	17	17	17	17	17	17	17	17	17	17	1	1	1
1	1	1	1	16	17	17	17	17	17	17	17	17	17	17	17	17	17	17	17	17	17	17	17	17	17	17	17	17	17	17	17	17	17	17	17	17	17	17	17	17	17	17	17	17	17	17	17	17	17	17	17	17	17	1	1	1
1	1	1	1	16	17	17	17	17	17	17	17	17	17	17	17	17	17	17	17	17	17	17	17	16	16	16	16	16	16	16	16	16	16	16	16	16	16	16	16	16	16	16	16	16	16	16	16	16	16	16	16	16	16	1	1	1
1	1	1	1	16	17	17	17	17	17	17	17	17	17	17	17	17	17	17	17	17	17	17	17	16	16	16	16	16	16	16	16	16	16	16	16	16	16	16	16	16	16	16	16	16	16	16	16	16	16	16	16	16	16	1	1	1
1	1	1	1	16	17	17	17	17	17	17	17	17	17	17	17	17	17	17	17	17	17	17	17	16	16	16	16	16	16	16	16	16	16	16	16	16	16	16	16	16	16	16	16	16	16	16	16	16	16	16	16	16	16	1	1	1
1	1	1	1	17	44	44	44	44	44	44	44	44	44	44	44	44	44	44	44	0	44	44	44	16	16	16	16	16	16	16	16	16	16	16	16	16	16	16	16	16	16	16	16	16	16	16	16	16	16	16	16	16	16	1	1	1
1	1	1	1	17	44	44	44	44	44	44	44	44	44	44	44	44	44	44	44	44	44	44	44	16	16	16	16	16	16	16	16	16	16	16	16	16	16	16	16	16	16	16	16	16	16	16	16	16	16	16	16	16	16	1	1	1
1	1	1	1	17	44	44	44	44	44	44	44	44	44	44	44	44	44	44	44	44	44	44	44	17	17	17	17	16	16	16	16	16	16	16	16	16	16	16	16	16	16	16	16	16	16	16	16	16	16	16	16	16	16	1	1	1
1	1	1	0	44	44	44	44	44	44	44	44	44	44	44	44	44	44	44	44	44	44	44	44	17	17	17	17	16	16	16	16	16	16	16	16	16	16	16	16	16	16	16	16	16	16	16	16	16	16	16	16	16	16	1	1	1
1	1	1	1	16	16	16	16	16	16	44	44	44	44	44	44	44	44	44	44	44	44	44	44	17	0	17	17	17	17	17	17	17	17	17	17	17	17	17	17	16	16	16	16	16	16	16	16	16	16	16	16	16	16	1	1	1
1	1	1	1	1	1	1	1	1	16	44	44	44	44	44	44	44	44	44	44	44	44	44	44	44	44	44	17	17	17	17	17	17	17	17	17	17	17	17	17	16	16	16	16	16	16	16	16	16	16	16	16	16	16	1	1	1
1	1	1	1	1	1	1	1	1	16	44	44	44	44	44	44	44	44	44	44	44	44	44	44	44	44	44	17	17	17	17	17	17	17	17	17	17	17	17	17	16	16	16	16	16	16	16	16	16	16	16	16	16	16	1	1	1
1	1	1	1	1	1	1	1	1	16	44	44	44	44	44	44	44	44	44	44	44	44	44	44	44	44	44	17	17	17	17	17	17	17	17	17	17	17	17	17	16	16	16	16	16	16	16	16	16	16	16	16	16	16	1	1	1
1	1	1	1	1	1	1	1	1	16	17	17	17	17	17	17	17	17	17	18	18	18	17	17	17	17	17	17	17	17	17	17	17	17	17	17	17	17	17	17	16	16	16	16	16	16	16	16	16	16	16	16	16	16	1	1	1
1	1	1	1	1	1	1	1	1	16	17	17	17	17	17	17	17	17	17	18	18	18	17	17	17	17	17	17	17	17	17	17	17	17	17	17	17	17	17	17	16	16	16	16	16	16	16	16	16	16	16	16	16	16	1	1	1
1	1	1	1	1	1	1	1	1	16	17	1	1	1	1	17	17	17	17	18	18	18	17	17	17	17	17	17	17	17	17	17	17	17	17	17	17	17	17	17	16	16	16	16	16	16	16	16	16	16	16	16	16	16	1	1	1
1	1	1	1	1	1	1	1	1	16	17	1	1	1	1	17	17	17	17	18	18	18	17	17	17	17	17	17	17	17	17	17	17	17	17	17	17	17	17	17	16	16	16	16	16	16	16	16	16	16	16	16	16	16	1	1	1
1	1	1	1	1	1	1	1	1	16	17	1	1	1	1	17	17	17	17	18	18	18	17	17	17	17	17	17	17	17	17	17	17	17	17	17	17	17	17	17	16	16	16	16	16	16	16	16	16	16	16	16	16	16	1	1	1
1	1	1	1	1	1	1	1	1	16	44	44	44	44	44	44	44	44	44	44	44	44	44	44	44	44	44	17	17	17	17	17	17	17	17	17	17	17	17	17	16	16	16	16	16	16	16	16	16	16	16	16	16	16	1	1	1
1	1	1	1	1	1	1	1	1	16	44	44	44	44	44	44	44	44	44	44	44	44	44	44	44	44	44	17	17	17	17	17	17	17	17	17	17	17	17	17	16	16	16	16	16	16	16	16	16	16	16	16	16	16	1	1	1
1	1	1	1	1	1	1	1	1	16	44	44	44	44	44	44	44	44	44	44	44	44	44	44	44	44	44	17	17	17	17	17	17	17	17	17	17	17	17	17	16	16	16	16	16	16	16	16	16	16	16	16	16	16	1	1	1
1	1	1	1	1	1	1	1	1	16	44	44	44	44	44	44	44	44	44	44	44	44	44	44	44	44	44	17	17	17	17	17	17	17	17	17	17	17	17	17	17	17	17	17	16	16	16	16	16	16	16	16	16	16	1	1	1
1	1	1	1	1	1	1	1	1	16	44	44	44	44	44	44	44	44	44	44	44	44	44	44	44	44	44	17	17	17	17	17	17	17	17	17	17	17	17	17	17	17	17	17	16	16	16	16	16	16	16	16	16	16	1	1	1
1	1	1	1	1	1	1	1	1	16	44	44	44	44	44	44	44	44	44	44	44	44	44	44	44	44	44	44	44	44	44	44	44	44	44	44	44	44	44	44	17	17	17	17	16	16	16	16	16	16	16	16	16	16	1	1	1
1	1	1	1	1	1	1	1	1	16	44	44	44	44	44	44	44	44	44	44	44	44	44	44	44	44	44	44	44	44	44	44	44	44	44	44	44	44	44	44	44	44	44	44	16	16	16	16	16	16	16	16	16	16	1	1	1
1	1	1	1	1	1	1	1	1	16	44	44	44	44	44	44	44	44	44	44	44	44	44	44	44	44	44	44	44	44	44	44	44	44	44	44	44	44	44	44	44	44	44	44	16	16	16	16	16	16	16	16	16	16	1	1	1
1	1	1	1	1	1	1	1	1	16	44	44	44	44	44	44	44	44	44	44	44	44	44	44	44	44	44	44	44	44	44	44	44	44	44	44	44	44	44	44	44	44	44	44	16	16	16	16	16	16	16	16	16	16	1	1	1
1	1	1	1	1	1	1	1	1	16	44	44	44	44	44	44	44	16	16	16	16	16	16	16	16	16	16	16	16	16	16	16	16	16	44	44	44	44	44	44	44	44	44	44	16	16	16	16	16	16	16	16	16	16	1	1	1
1	1	1	1	1	1	1	1	1	16	44	44	44	44	44	44	44	16	16	16	16	16	16	16	16	16	16	16	16	16	16	16	16	16	44	44	44	44	44	44	44	44	44	44	16	16	16	16	16	16	16	16	16	16	1	1	1
1	1	1	1	1	1	1	1	1	16	44	44	44	44	44	44	44	16	16	16	16	16	16	16	16	16	16	16	16	16	16	16	16	16	44	44	44	44	44	16	16	16	16	16	16	16	16	16	16	16	16	16	16	16	1	1	1
1	1	1	1	1	1	1	1	1	16	44	44	44	44	44	44	44	17	17	16	16	16	17	17	17	17	17	17	17	17	17	17	17	17	44	44	44	44	44	16	16	16	16	16	16	16	16	16	16	16	16	16	16	16	1	1	1
1	1	1	1	1	1	1	1	1	16	44	44	44	44	44	44	44	17	17	16	16	16	17	17	17	17	17	17	17	17	17	0	17	17	44	44	44	44	44	16	16	16	16	16	16	16	16	16	16	16	16	16	16	16	1	1	1
1	1	1	1	1	1	1	1	1	16	44	44	44	44	44	44	44	44	44	16	16	16	44	44	44	44	44	44	44	44	44	44	44	44	44	44	44	44	44	16	16	16	16	16	16	16	16	16	16	16	16	16	16	16	1	1	1
1	1	1	1	1	1	1	1	1	16	44	44	44	44	44	44	44	44	44	16	16	16	44	44	44	44	44	44	44	44	44	44	44	44	44	44	44	44	44	16	16	16	16	16	16	16	16	16	16	16	16	16	16	16	1	1	1
1	1	1	1	1	1	1	1	1	16	44	44	44	44	44	44	44	44	44	16	16	16	44	44	44	44	44	44	44	44	44	44	44	44	44	44	44	44	44	16	16	16	16	16	16	16	16	16	16	16	16	16	16	16	1	1	1
1	1	1	1	1	1	1	1	1	16	44	44	44	44	44	44	44	44	44	16	16	16	44	44	44	44	44	44	44	44	44	44	44	44	44	44	44	44	44	16	16	16	16	16	16	16	16	16	16	16	16	16	16	16	1	1	1
1	1	1	1	1	1	1	1	1	16	16	16	16	16	16	16	16	16	16	16	16	16	16	16	16	16	16	16	16	16	16	16	16	16	44	44	44	44	44	16	16	16	16	16	16	16	16	16	16	16	16	16	16	16	1	1	1
1	1	1	1	1	1	1	1	1	16	16	16	16	16	16	16	16	16	16	16	16	16	16	16	16	16	16	16	16	16	16	16	16	16	44	44	44	44	44	16	16	16	16	16	16	16	16	16	16	16	16	16	16	16	1	1	1
1	1	1	1	1	1	1	1	1	16	16	16	16	16	16	16	16	16	16	16	16	16	16	16	16	16	16	16	16	16	16	16	16	16	44	44	44	44	44	16	16	16	16	16	16	16	16	16	16	16	16	16	16	16	1	1	1
1	1	1	1	1	1	1	1	1	16	16	16	16	16	16	16	16	16	16	16	16	16	16	16	16	16	16	16	16	16	16	16	16	16	44	44	44	44	44	16	16	16	16	16	16	16	16	16	16	16	16	16	16	16	1	1	1
1	1	1	1	1	1	1	1	1	16	16	16	16	16	16	16	16	16	16	16	16	16	16	16	16	16	16	16	16	16	16	16	16	16	44	44	44	44	44	16	16	16	16	16	16	16	16	16	16	16	16	16	16	16	1	1	1
1	1	1	1	1	1	1	1	1	16	16	16	16	16	16	16	16	16	16	16	16	16	16	16	16	16	16	16	16	16	16	16	16	16	44	44	44	44	44	16	16	16	16	16	16	16	16	16	16	16	16	16	16	16	1	1	1
1	1	1	1	1	1	1	1	1	16	16	16	16	16	16	16	16	16	16	16	16	16	16	16	16	16	16	16	16	16	16	16	16	16	44	44	44	44	44	16	16	16	16	16	16	16	16	16	16	16	16	16	16	16	1	1	1
1	1	1	1	1	1	1	1	1	16	16	16	16	16	16	16	16	16	16	16	16	16	16	16	16	16	16	16	16	16	16	16	16	16	44	44	44	44	44	16	16	16	16	16	16	16	16	16	16	16	16	16	16	16	1	1	1
1	1	1	1	1	1	1	1	1	16	16	16	16	16	16	16	16	16	16	16	16	16	16	16	16	16	16	16	16	16	16	16	16	16	44	44	44	44	44	16	16	16	16	16	16	16	16	16	16	16	16	16	16	16	1	1	1
1	1	1	1	1	1	1	1	1	1	1	1	1	1	1	1	1	1	1	1	1	1	1	1	1	1	1	1	1	1	1	1	1	1	1	1	1	1	1	1	1	1	1	1	1	1	1	1	1	1	1	1	1	1	1	1	1
1	1	1	1	1	1	1	1	1	1	1	1	1	1	1	1	1	1	1	1	1	1	1	1	1	1	1	1	1	1	1	1	1	1	1	1	1	1	1	1	1	1	1	1	1	1	1	1	1	1	1	1	1	1	1	1	1
1	1	1	1	1	1	1	1	1	1	1	1	1	1	1	1	1	1	1	1	1	1	1	1	1	1	1	1	1	1	1	1	1	1	1	1	1	1	1	1	1	1	1	1	1	1	1	1	1	1	1	1	1	1	1	1	1
201 25 16
202 20 12
203 31 38
205 3 15
254 33 39
14 10
18 10
3