15 12
6 9
4
0
0 0
2   2   126 133 133 133 133 133 133 133 133 133 133 133 2
2   132 134 115 115 115 115 115 115 115 115 115 115 115 2
2   115 115 121 121 1   121 121 121 1   121 121 121 121 2
2   121 121 27  28  31  28  28  28  31  28  28  28  28  1
1   27  28  31  31  31  31  31  31  31  31  32  126 127 2  
2   132 128 30  31  31  31  31  31  31  31  32  131 2   2
2   2   131 30  31  31  31  31  31  31  31  32  131 2   2
2   2   131 30  31  31  31  31  31  31  31  32  131 2   2
2   2   131 30  31  31  31  31  31  31  31  32  131 2   2
2   2   131 33  34  34  34  34  34  34  34  35  131 2   2
2   2   132 127 127 127 127 127 127 127 127 127 134 2   2
2   2   2   2   2   2   2   2   2   2   2   2   2   2   2
160 0 4
161 5 2
162 9 2
163 14 3