21 19
10 14
6
0
0 0
1	1	1	1	1	1	1	1	1	1	1	1	1	1	1	1	1	1	1	1	1
1	1	1	1	1	1	1	1	1	1	1	1	1	1	1	1	1	1	1	1	1
1	1	1	1	1	1	1	1	1	1	1	1	1	1	1	1	1	1	1	1	1
1	1	1	1	1	16	16	16	16	16	16	16	16	16	16	16	1	1	1	1	1
1	1	1	1	1	16	17	17	17	17	17	17	17	17	17	17	1	1	1	1	1
1	1	1	1	1	17	17	17	17	17	17	17	17	17	17	17	1	0	1	1	1
1	1	1	1	1	17	17	17	17	17	0	17	17	17	17	17	20	0	1	1	1
1	1	1	1	1	17	27	27	27	27	27	27	27	27	27	20	20	1	1	1	1
1	1	1	1	1	20	27	27	27	27	27	27	27	27	27	20	1	1	1	1	1
1	1	1	0	20	16	27	27	27	27	27	27	27	27	27	16	1	1	1	1	1
1	1	1	0	1	16	27	27	27	27	27	27	27	27	27	16	1	1	1	1	1
1	1	1	1	1	16	27	27	27	27	27	27	27	27	27	16	1	1	1	1	1
1	1	1	1	1	16	27	27	27	27	27	27	27	27	27	16	1	1	1	1	1
1	1	1	1	1	16	27	27	27	27	27	27	27	27	27	16	1	1	1	1	1
1	1	1	1	1	16	16	16	16	16	27	16	16	16	16	16	1	1	1	1	1
1	1	1	1	1	1	1	1	1	1	0	1	1	1	1	1	1	1	1	1	1
1	1	1	1	1	1	1	1	1	1	1	1	1	1	1	1	1	1	1	1	1
1	1	1	1	1	1	1	1	1	1	1	1	1	1	1	1	1	1	1	1	1
1	1	1	1	1	1	1	1	1	1	1	1	1	1	1	1	1	1	1	1	1
187 10 15
188 10 6
189 3 9
189 3 10
190 17 5
190 17 6