28 30
15 23
4
0 0
2   2   2   2   2   2   2   2   2   2   2   2   2   2   2   2   2   2   2   2   2   2   2   2   2   2   2   2
2   2   2   2   2   2   2   2   2   2   2   2   2   2   2   2   2   2   2   2   2   2   2   2   2   2   2   2
2   2   2   2   2   2   2   2   2   2   2   2   2   2   2   2   2   2   2   2   2   2   2   2   2   2   2   2
2   2   2   2   2   188 188 188 188 183 2   2   2   2   181 188 188 188 188 188 183 2   2   2   2   2   2   2
2   2   2   2   2   170 170 170 170 184 2   2   2   181 189 170 170 170 170 170 187 183 2   2   2   2   2   2   
2   2   2   2   2   176 176 176 176 184 2   2   181 189 170 176 176 1   176 176 170 187 183 2   2   2   2   2
2   2   2   2   1   191 191 191 191 184 2   181 189 170 176 191 191 191 191 191 176 170 187 183 2   2   2   2
2   2   2   2   2   186 191 191 191 184 182 189 170 176 191 191 191 191 191 191 191 176 170 187 183 2   2   2  
2   2   2   2   2   186 191 191 191 184 189 170 176 191 191 191 191 191 191 191 191 191 176 170 187 183 2   2  
2   2   2   2   2   186 192 192 192 185 170 176 191 191 191 181 188 191 188 183 191 191 191 176 170 184 2   2   
2   2   2   2   2   186 192 192 192 185 176 191 191 191 181 189 170 191 170 187 183 191 191 191 176 184 2   2 
2   2   2   2   2   186 192 192 192 185 191 191 191 181 189 170 176 191 176 170 187 183 191 191 191 184 2   2 
2   2   2   2   2   186 191 191 191 185 191 191 191 186 170 176 191 191 191 176 170 184 191 191 191 184 2   2 
2   2   2   2   2   170 191 191 191 170 191 191 191 186 176 191 191 191 191 191 176 184 191 191 191 184 2   2 
2   2   2   2   2   176 191 191 191 176 191 191 191 170 191 191 181 193 183 191 191 170 191 191 191 184 2   2 
2   2   2   2   1   191 191 191 191 191 191 191 191 176 191 191 185 193 185 191 191 176 191 191 191 184 2   2 
2   2   2   2   2   186 191 191 191 185 191 191 191 191 191 191 187 185 189 191 191 191 191 191 191 184 2   2 
2   2   2   2   2   186 191 191 191 185 191 191 191 186 191 191 170 188 170 191 191 184 191 191 191 184 2   2 
2   2   2   2   2   186 191 191 191 185 191 191 191 186 191 191 176 170 176 191 191 184 191 191 191 184 2   2 
2   2   2   2   2   186 192 192 192 185 191 191 191 187 183 191 191 176 191 191 181 189 191 191 191 184 2   2 
2   2   2   2   2   186 192 192 192 185 191 191 191 170 187 183 191 191 191 181 189 170 191 191 191 184 2   2
2   2   2   2   2   186 192 192 192 185 191 191 191 176 170 187 188 191 188 189 170 176 191 191 191 184 2   2 
2   2   2   2   2   186 191 191 191 185 183 191 191 191 176 170 170 191 170 170 176 191 191 191 181 189 2   2
2   2   2   2   2   170 191 191 191 185 188 183 191 191 191 176 176 191 176 176 191 191 191 181 189 2   2   2
2   2   2   2   2   176 191 191 191 184 2   187 183 191 191 191 191 191 191 191 191 191 181 189 2   2   2   2
2   2   2   2   1   191 191 191 191 184 2   2   187 183 191 191 191 191 191 191 191 181 189 2   2   2   2   2
2   2   2   2   2   187 188 188 188 189 2   2   2   187 183 191 191 191 191 191 181 189 2   2   2   2   2   2   
2   2   2   2   2   2   2   2   2   2   2   2   2   2   187 188 188 188 188 188 189 2   2   2   2   2   2   2
2   2   2   2   2   2   2   2   2   2   2   2   2   2   2   2   2   2   2   2   2   2   2   2   2   2   2   2
2   2   2   2   2   2   2   2   2   2   2   2   2   2   2   2   2   2   2   2   2   2   2   2   2   2   2   2
199 17 14
200 4 6
201 4 15
202 4 25