41 46
15 23
0
0 0
2   2   2   2   2   2   2   2   2   2   2   2   2   2   2   2   2   2   2   2   2   2   2   2   2   2   2   2   2   2   2   2   2   2   2   2   2   2   2   2   2
2   2   2   2   2   2   2   2   2   2   2   2   2   2   2   2   2   2   2   2   2   2   2   2   2   2   2   2   2   2   2   2   2   2   2   2   2   2   2   2   2
2   2   2   2   2   2   2   2   2   2   2   2   2   2   2   2   2   2   2   2   2   2   2   2   2   2   2   2   2   2   2   2   2   2   2   2   2   2   2   2   2
2   2   2   2   2   2   2   2   2   2   2   2   2   2   2   2   2   2   2   2   2   2   2   2   2   2   2   2   2   2   2   2   2   2   2   2   2   2   2   2   2
2   2   2   2   2   2   2   2   2   2   2   2   2   2   2   2   2   2   181 188 188 188 188 188 188 188 183 2   2   2   2   2   2   2   2   2   2   2   2   2   2
2   2   2   2   2   2   2   2   2   2   2   2   2   2   2   2   2   181 189 170 170 170 170 170 170 170 187 183 2   2   2   2   2   2   2   2   2   2   2   2   2
2   2   2   2   2   2   2   2   2   2   2   2   2   2   2   2   181 189 170 176 176 176 176 176 176 176 170 187 183 2   2   2   2   2   2   2   2   2   2   2   2
2   2   2   2   2   2   2   2   2   2   2   2   2   2   2   181 189 170 176 191 191 191 191 191 191 191 176 170 187 183 2   2   2   2   2   2   2   2   2   2   2
2   2   2   2   2   2   2   2   2   2   2   2   2   2   181 189 170 176 191 191 191 191 191 191 191 191 191 176 170 187 183 2   2   2   2   2   2   2   2   2   2
2   2   2   2   2   2   2   2   2   2   2   2   2   181 189 170 176 191 191 191 191 191 191 191 191 191 191 191 176 170 187 183 2   2   2   2   2   2   2   2   2
2   2   2   2   2   2   2   2   2   2   2   2   181 189 170 176 191 191 191 191 191 191 191 191 191 191 191 191 191 176 170 187 183 2   2   2   2   2   2   2   2
2   2   2   2   2   2   2   2   2   2   2   181 189 170 176 191 191 191 191 191 191 191 191 191 191 191 191 191 191 191 176 170 187 183 2   2   2   2   2   2   2
2   2   2   2   2   2   2   2   2   2   181 189 170 176 191 191 191 191 191 181 182 182 182 182 182 183 191 191 191 191 191 176 170 187 183 2   2   2   2   2   2
2   2   2   2   2   2   2   2   2   181 189 170 176 191 191 191 191 191 181 185 185 185 185 185 185 185 183 191 191 191 191 191 176 170 187 183 2   2   2   2   2
2   2   2   2   2   2   181 188 188 189 170 176 191 191 191 191 191 181 185 185 185 185 185 185 185 185 185 183 191 191 191 191 191 176 170 187 183 2   2   2   2
2   2   2   2   2   2   186 170 170 170 176 191 191 191 191 191 181 185 185 185 185 185 185 185 185 185 185 185 183 191 191 191 191 191 176 170 184 2   2   2   2
2   2   2   2   2   2   186 176 176 176 191 191 191 191 191 181 185 185 185 185 185 185 185 185 185 185 185 185 185 183 191 191 191 191 191 176 184 2   2   2   2
2   2   2   2   2   2   186 191 191 191 191 191 191 191 181 185 185 185 185 185 185 185 185 185 185 185 185 185 185 185 183 191 191 191 191 191 184 2   2   2   2
2   2   2   2   2   2   186 191 191 191 191 191 191 191 184 185 185 185 185 185 185 185 185 185 185 185 185 185 185 185 186 191 191 191 191 191 184 2   2   2   2
2   2   2   2   2   2   186 191 191 191 191 191 191 191 184 185 185 185 185 185 185 185 185 185 185 185 185 185 185 185 186 191 191 191 191 191 184 2   2   2   2
2   2   2   2   2   2   186 191 191 191 191 191 191 191 184 185 185 185 185 185 185 185 185 185 185 185 185 185 185 185 186 191 191 191 191 191 184 2   2   2   2
2   2   2   2   2   2   186 191 191 191 191 191 191 191 184 185 185 185 185 185 185 185 185 185 185 185 185 185 185 185 186 191 191 191 191 191 184 2   2   2   2
2   2   2   2   2   2   186 191 191 191 191 191 191 191 188 188 188 188 185 185 185 185 185 185 185 185 185 185 185 185 186 191 191 191 191 191 184 2   2   2   2
2   2   2   2   2   181 188 188 188 183 191 191 191 191 170 170 170 170 184 185 185 185 185 185 185 185 185 185 185 185 186 191 191 191 191 191 184 2   2   2   2
2   2   2   2   2   186 170 170 170 188 188 191 191 191 176 176 176 176 184 185 185 185 185 185 185 185 185 185 185 185 186 191 191 191 191 191 184 2   2   2   2
2   2   2   2   2   186 176 176 176 170 170 191 191 191 191 191 191 191 184 185 185 185 185 185 185 185 185 185 185 185 186 191 191 191 191 191 184 2   2   2   2
2   2   2   2   2   186 191 191 191 176 176 191 191 191 191 191 191 191 184 185 185 185 185 185 185 185 185 185 185 185 186 191 191 191 191 191 184 2   2   2   2
2   2   2   2   2   186 191 191 191 191 191 191 191 191 191 191 191 191 184 185 185 185 185 185 185 185 185 185 185 185 186 191 191 191 191 191 184 2   2   2   2
2   2   2   2   2   186 191 191 191 191 191 191 191 191 191 191 191 191 187 185 185 185 185 185 185 185 185 185 185 185 186 191 191 191 191 191 184 2   2   2   2
2   2   2   2   2   186 191 191 191 191 191 191 191 191 191 191 191 191 170 187 185 185 185 185 185 185 185 185 185 185 186 191 191 191 191 191 184 2   2   2   2
2   2   2   2   2   186 191 191 191 181 188 188 188 188 185 191 191 191 176 170 187 188 188 188 188 188 188 185 185 185 186 191 191 191 191 191 184 2   2   2   2
2   2   2   2   2   186 191 191 191 184 2   2   2   2   188 183 191 191 191 176 170 170 170 170 170 170 170 185 185 185 189 191 191 191 191 191 184 2   2   2   2
2   2   2   2   2   186 191 191 191 170 2   2   2   2   2   185 183 191 191 191 176 176 176 1   176 176 1   185 185 189 170 191 191 191 191 191 184 2   2   2   2
2   2   2   2   2   186 191 191 191 176 2   2   2   2   2   186 187 183 191 191 191 191 191 191 191 191 191 185 189 170 176 191 191 191 191 191 184 2   2   2   2
2   2   2   2   2   186 191 191 191 191 1   2   2   2   2   186 170 187 183 191 191 191 191 191 191 191 181 189 170 176 191 191 191 191 191 181 189 2   2   2   2
2   2   2   2   2   186 191 191 191 184 2   2   2   2   2   186 176 170 187 191 191 191 184 185 185 185 189 170 176 191 191 191 191 191 181 189 2   2   2   2   2
2   2   2   2   2   187 188 188 188 189 2   2   2   2   2   186 191 176 170 191 191 191 188 188 188 189 170 176 191 191 191 191 191 181 189 2   2   2   2   2   2
2   2   2   2   2   2   2   2   2   2   2   2   2   2   2   186 191 191 176 191 191 191 170 170 170 170 176 191 191 191 191 191 181 189 2   2   2   2   2   2   2
2   2   2   2   2   2   2   2   2   2   2   2   2   2   2   186 191 191 191 191 191 191 176 176 176 176 191 191 191 191 191 181 189 2   2   2   2   2   2   2   2
2   2   2   2   2   2   2   2   2   2   2   2   2   2   2   186 191 191 191 191 191 191 191 191 191 191 191 191 191 191 181 189 2   2   2   2   2   2   2   2   2
2   2   2   2   2   2   2   2   2   2   2   2   2   2   2   186 191 191 191 191 191 191 191 191 191 191 191 191 191 181 189 2   2   2   2   2   2   2   2   2   2
2   2   2   2   2   2   2   2   2   2   2   2   2   2   2   187 183 191 191 191 191 191 191 191 191 191 191 191 181 189 2   2   2   2   2   2   2   2   2   2   2
2   2   2   2   2   2   2   2   2   2   2   2   2   2   2   2   187 183 191 191 191 191 191 191 191 191 191 181 189 2   2   2   2   2   2   2   2   2   2   2   2
2   2   2   2   2   2   2   2   2   2   2   2   2   2   2   2   2   187 183 191 191 191 191 191 191 191 181 189 2   2   2   2   2   2   2   2   2   2   2   2   2
2   2   2   2   2   2   2   2   2   2   2   2   2   2   2   2   2   2   187 188 188 188 188 188 188 188 189 2   2   2   2   2   2   2   2   2   2   2   2   2   2
2   2   2   2   2   2   2   2   2   2   2   2   2   2   2   2   2   2   2   2   2   2   2   2   2   2   2   2   2   2   2   2   2   2   2   2   2   2   2   2   2
2   2   2   2   2   2   2   2   2   2   2   2   2   2   2   2   2   2   2   2   2   2   2   2   2   2   2   2   2   2   2   2   2   2   2   2   2   2   2   2   2