37 45
7 33
0
0 0
2   2   2   2   2   2   2   2   2   2   2   2   2   2   2   2   2   2   2   2   2   2   2   2   2   2   2   2   2   2   2   2   2   2   2   2   2
2   2   2   2   2   2   2   2   2   2   2   2   2   2   2   2   2   2   2   2   2   2   2   2   2   2   2   2   2   2   2   2   2   2   2   2   2
2   2   2   2   2   2   2   2   2   2   2   2   2   2   2   2   2   2   181 182 182 182 182 182 182 182 182 182 183 2   2   2   2   2   2   2   2
2   2   2   2   2   2   2   2   2   2   2   2   2   2   2   2   2   2   184 185 185 185 185 185 185 185 185 185 186 2   2   2   2   2   2   2   2
2   2   2   2   2   2   2   2   2   2   2   2   2   2   2   2   2   2   184 185 185 185 185 185 185 185 185 185 186 2   2   2   2   2   2   2   2
2   2   2   2   2   2   2   2   2   2   2   2   2   2   2   2   2   2   184 185 185 185 185 185 185 185 185 185 186 2   2   2   2   2   2   2   2
2   2   2   2   2   2   2   2   2   2   2   2   2   2   2   2   2   2   184 185 185 185 185 185 185 185 185 185 186 2   2   2   2   2   2   2   2
2   2   2   2   2   2   2   2   2   2   2   2   2   2   2   2   2   2   187 188 188 188 188 188 189 188 188 188 188 2   2   2   2   2   2   2   2
2   2   2   2   2   2   2   2   2   2   2   2   2   2   2   2   2   2   170 170 170 170 170 170 170 170 170 170 170 2   2   2   2   2   2   2   2
2   2   2   2   2   2   2   2   2   2   2   2   2   2   2   2   2   2   173 173 173 173 173 173 173 173 173 173 173 2   2   2   2   2   2   2   2
2   2   2   2   2   195 36  36  36  36  36  36  36  36  36  36  36  36  173 173 173 173 173 173 173 173 173 173 173 2   2   2   2   2   2   2   2
2   2   2   2   195 195 36  36  36  36  36  36  36  36  36  36  36  36  173 173 173 173 173 173 173 173 173 173 173 2   2   2   2   2   2   2   2
2   2   2   195 195 195 36  36  36  36  36  36  36  36  36  36  36  36  173 173 173 173 173 173 173 173 173 173 173 2   2   2   2   2   2   2   2
182 182 1   195 195 182 182 183 36  36  36  36  36  36  36  36  36  36  173 173 173 173 173 173 173 173 173 173 173 2   2   2   2   2   2   2   2
2   2   1   195 2   2   2   184 36  36  36  36  36  36  36  36  36  36  173 173 173 173 173 173 173 173 173 173 173 2   2   2   2   2   2   2   2
2   2   1   2   2   2   2   184 36  36  36  36  36  36  36  36  36  36  173 173 173 173 173 173 173 173 173 173 173 2   2   2   2   2   2   2   2
2   2   2   2   2   2   2   184 36  36  36  36  36  36  36  36  36  36  173 173 173 173 173 173 173 173 173 173 173 2   2   2   2   2   2   2   2
2   2   2   2   2   2   2   184 36  36  36  36  36  36  36  36  36  36  173 173 173 173 173 173 173 173 186 173 173 2   2   2   2   2   2   2   2
2   2   2   2   2   2   2   184 36  36  36  36  36  36  36  36  36  36  176 176 176 1   176 176 176 176 186 173 173 2   2   2   2   2   2   2   2
2   2   2   2   2   2   2   187 188 188 188 188 183 36  36  36  36  36  36  36  36  36  36  36  36  36  186 173 173 2   2   2   2   2   2   2   2
2   2   2   2   2   2   2   2   2   2   2   2   184 36  36  36  36  36  36  36  36  36  36  36  36  36  186 173 173 2   2   2   2   2   2   2   2
2   2   2   2   2   2   2   2   2   2   2   2   184 36  36  36  36  36  36  36  36  36  36  36  36  36  186 173 173 2   2   2   2   2   2   2   2
2   2   2   2   2   2   2   2   2   2   2   2   184 36  36  36  36  36  36  36  36  36  36  36  36  36  186 173 173 2   2   2   2   2   2   2   2
2   2   2   2   2   2   2   2   2   2   2   2   184 36  36  36  36  36  36  36  36  36  36  36  36  36  186 173 173 2   2   2   2   2   2   2   2
2   2   2   2   2   2   2   2   2   2   2   2   184 36  36  36  36  36  36  36  36  36  36  36  36  36  186 173 173 2   2   2   2   2   2   2   2
2   2   2   2   2   2   2   2   2   2   2   2   184 36  36  36  36  36  36  36  36  36  36  36  36  36  186 173 173 2   2   2   2   2   2   2   2
2   2   2   2   2   2   2   181 188 188 188 188 189 36  36  36  36  36  36  36  36  36  36  36  36  36  186 173 173 2   2   2   2   2   2   2   2
2   2   2   2   2   2   2   184 170 170 170 170 170 36  36  36  36  36  36  36  36  36  36  36  36  36  186 173 173 2   2   2   2   2   2   2   2
2   2   2   2   2   2   2   184 176 176 176 176 176 36  36  36  36  36  36  36  36  36  36  36  36  36  186 173 173 2   2   2   2   2   2   2   2
2   2   2   2   2   2   2   184 36  36  36  36  36  36  36  36  36  36  36  36  36  36  36  36  36  36  186 173 173 2   2   2   2   2   2   2   2
2   2   2   2   2   2   2   184 36  36  36  36  36  36  36  36  36  36  36  36  36  36  36  36  36  36  186 173 173 2   2   2   2   2   2   2   2
2   2   2   2   2   2   2   170 36  36  36  36  36  36  36  36  36  36  36  36  36  36  36  36  36  36  186 173 173 2   2   2   2   2   2   2   2
2   2   2   2   2   2   2   176 36  36  36  36  36  36  36  36  36  36  36  36  36  36  36  36  36  36  186 173 173 2   2   2   2   2   2   2   2
2   2   2   2   2   2   1   36  36  36  36  36  36  36  36  36  36  36  36  36  36  36  36  36  181 182 182 182 182 182 182 182 182 182 182 182 182
2   2   2   2   2   2   2   184 36  36  36  36  36  36  36  36  36  36  36  36  36  36  36  36  186 2   2   2   2   2   2   2   2   2   2   2   2
2   2   2   2   2   2   2   184 36  36  36  36  36  36  36  36  36  36  36  36  36  36  36  36  186 2   2   2   2   2   2   2   2   2   2   2   2
2   2   2   2   2   2   2   184 36  36  36  36  36  36  36  36  36  36  36  36  36  36  36  36  186 2   2   2   2   2   2   2   2   2   2   2   2
2   2   2   2   2   2   2   184 36  36  36  36  36  36  36  36  36  36  36  36  36  36  36  36  186 2   2   2   2   2   2   2   2   2   2   2   2
2   2   2   2   2   2   2   184 36  36  36  36  36  36  36  36  36  36  36  36  36  36  36  36  186 2   2   2   2   2   2   2   2   2   2   2   2
2   2   2   2   2   2   2   184 36  36  36  36  36  36  36  36  36  36  36  36  36  36  36  36  186 2   2   2   2   2   2   2   2   2   2   2   2
2   2   2   2   2   2   2   184 36  36  36  36  36  36  36  36  36  36  36  36  36  36  36  36  186 2   2   2   2   2   2   2   2   2   2   2   2
2   2   2   2   2   2   2   184 36  36  36  36  36  36  36  36  36  36  36  36  36  36  36  36  186 2   2   2   2   2   2   2   2   2   2   2   2
2   2   2   2   2   2   2   187 188 188 188 36  188 188 188 188 188 188 188 188 188 188 188 188 189 2   2   2   2   2   2   2   2   2   2   2   2
2   2   2   2   2   2   2   2   2   2   2   1   2   2   2   2   2   2   2   2   2   2   2   2   2   2   2   2   2   2   2   2   2   2   2   2   2
2   2   2   2   2   2   2   2   2   2   2   2   2   2   2   2   2   2   2   2   2   2   2   2   2   2   2   2   2   2   2   2   2   2   2   2   2
