14 27
12 15
0
0 0
2   2   2   2   1   2   2   2   2   2   2   2   2   2   2   2   2   2   2   2   2   2   2   2   2   2   2   2   2   2   
187 188 188 188 188 188 188 188 189 2   2   2   2   2   2   2   2   2   2   2   2   2   2   2   2   2   2   2   2   2   
184 170 170 170 170 170 170 170 186 2   2   2   2   2   2   2   2   2   2   2   2   2   2   2   2   2   2   2   2   2   
184 176 176 176 1   176 176 176 186 2   2   181 182 182 182 182 182 182 182 182 182 182 182 182 182 182 182 182 182 183
184 191 191 191 191 191 191 191 186 2   2   184 170 170 170 170 170 170 170 170 170 170 170 170 170 170 170 170 170 186
184 191 191 191 191 191 191 191 186 2   2   184 176 176 176 176 176 176 176 176 176 176 176 176 176 176 176 176 176 186
184 191 191 191 191 191 191 191 186 2   2   184 194 194 194 194 194 194 194 194 194 194 194 194 194 194 194 194 194 186
184 191 191 191 191 191 191 191 187 188 188 189 194 194 194 194 194 194 194 194 194 194 194 194 194 194 194 194 194 186
184 191 191 191 191 191 191 191 191 191 191 191 194 194 194 194 194 194 194 194 194 194 194 194 194 194 194 194 194 186 
184 191 191 191 191 191 191 191 191 191 191 191 194 194 194 194 194 194 194 194 194 194 194 194 194 194 194 194 194 186
184 191 191 191 191 191 191 191 191 191 191 191 194 194 194 194 194 194 194 194 194 194 194 194 194 194 194 194 194 186 
184 191 191 191 191 191 191 191 191 191 191 191 194 194 194 194 194 194 194 194 194 194 194 194 194 194 194 194 194 186
184 191 191 191 191 191 191 191 191 191 191 191 194 194 194 194 194 194 194 194 194 194 194 194 194 194 194 194 194 186 
184 191 191 191 191 191 191 191 191 191 191 191 194 194 194 194 194 194 194 194 194 194 194 194 194 194 194 194 194 186
184 191 191 191 191 191 191 191 181 182 182 182 194 194 194 194 194 194 194 194 194 194 194 194 194 194 194 194 194 186
184 191 191 191 191 191 191 191 186 2   2   184 194 194 194 194 194 194 194 194 194 194 194 194 194 194 194 194 194 186 
184 191 191 191 191 191 191 191 186 2   2   184 194 194 194 194 194 194 194 194 194 194 194 194 194 194 194 194 194 186
184 191 191 191 191 191 191 191 186 2   2   184 194 194 194 194 194 194 194 194 194 194 194 194 194 194 194 194 194 186
187 188 188 188 191 188 188 188 189 2   2   184 194 194 194 194 194 194 194 194 194 194 194 194 194 194 194 194 194 186
2   2   2   2   1   2   2   2   2   2   2   184 194 194 194 194 194 194 194 194 194 194 194 194 194 194 194 194 194 186 
2   2   2   2   2   2   2   2   2   2   2   184 194 194 194 194 194 194 194 194 194 194 194 194 194 194 194 194 194 186 
2   2   2   2   2   2   2   2   2   2   2   184 191 191 191 194 194 194 194 194 194 194 194 194 194 194 194 194 194 186
2   2   2   2   2   2   2   2   2   2   2   184 191 191 191 194 194 194 194 194 194 194 194 194 194 194 194 194 194 186
2   2   2   2   2   2   2   2   2   2   2   184 191 191 191 194 194 194 194 194 194 194 194 194 194 194 194 194 194 186
2   2   2   2   2   2   2   2   2   2   2   184 191 191 191 194 194 194 194 194 194 194 194 194 194 194 194 194 194 186
2   2   2   2   2   2   2   2   2   2   2   184 191 191 191 194 194 194 194 194 194 194 194 194 194 194 194 194 194 186
2   2   2   2   2   2   2   2   2   2   2   184 191 191 191 194 194 194 194 194 194 194 194 194 194 194 194 194 194 186
2   2   2   2   2   2   2   2   2   2   2   184 191 191 191 194 194 194 194 194 194 194 194 194 194 194 194 194 194 186
2   2   2   2   2   2   2   2   2   2   2   184 191 191 191 194 194 194 194 194 194 194 194 194 194 194 194 194 194 186
2   2   2   2   2   2   2   2   2   2   2   184 191 191 191 194 194 194 194 194 194 194 194 194 194 194 194 194 194 186
2   2   2   2   2   2   2   2   2   2   2   184 191 191 191 194 194 194 194 194 194 194 194 194 194 194 194 194 194 186
2   2   2   2   2   2   2   2   2   2   2   187 188 188 188 188 188 188 188 188 188 188 188 188 188 188 188 188 188 189