10 13
4 11
1
0 0
2   2   2   2   2   2   2   2   2   2
181 188 188 188 188 188 188 188 183 2
186 170 170 170 170 170 170 170 184 2
186 176 176 176 176 176 176 176 184 2
186 191 191 191 191 191 191 191 184 2
186 191 191 191 191 191 191 191 184 2
186 191 191 191 191 191 191 191 170 2
186 191 191 191 191 191 191 191 176 2
186 191 191 191 191 191 191 191 191 1
186 191 191 191 191 191 191 191 184 2
186 191 191 191 191 191 191 191 184 2
187 188 188 188 188 188 188 188 189 2
2   2   2   2   2   2   2   2   2   2
228 9 8