28 43
12 15
0
0 0
2   2   2   2   2   2   2   2   2   2   2   2   2   2   2   2   2   2   2   2   2   2   2   2   2   2   2   2
2   2   2   2   2   2   2   2   188 182 182 182 182 182 182 182 182 182 182 182 182 182 182 182 182 182 183 2 
2   2   2   2   2   2   2   2   170 170 170 170 170 170 170 170 170 170 170 170 170 170 170 186 170 170 186 2
2   2   2   2   2   2   2   2   176 173 173 173 173 173 173 173 173 173 173 173 173 173 173 186 173 173 186 2
2   2   2   2   2   2   2   1   196 176 173 173 173 173 173 173 173 173 173 173 173 173 173 186 173 173 186 2
2   2   2   2   2   2   2   1   196 196 176 176 176 176 176 176 176 176 176 176 176 176 1   186 173 173 186 2
181 182 182 182 182 182 183 1   196 196 196 191 191 191 191 191 191 191 191 191 191 191 191 186 173 173 186 2
184 170 170 170 170 170 186 2   2   196 196 191 191 191 191 191 191 191 191 191 191 191 191 186 173 173 186 2
184 176 176 1   176 176 186 2   2   2   196 191 191 191 191 191 191 191 191 191 191 191 191 186 173 173 186 2
184 191 191 191 191 191 186 2   184 188 188 188 188 188 188 188 192 192 188 188 188 188 188 189 173 173 186 2
184 191 191 191 191 191 186 2   184 170 170 170 170 170 170 184 192 192 186 170 170 170 170 170 173 173 186 2
184 191 191 191 191 191 186 2   184 176 176 176 176 176 176 184 192 192 186 176 176 176 176 176 176 176 186 2
184 191 191 191 191 191 187 188 189 194 194 194 194 194 194 170 192 192 170 194 194 194 194 194 194 194 186 2
184 191 191 191 191 191 170 170 170 194 194 194 194 194 194 194 194 194 194 194 194 194 194 194 194 194 186 2
184 191 191 191 191 191 176 176 176 194 194 194 194 194 194 194 194 194 194 194 194 194 194 194 194 194 186 2
184 191 191 191 191 191 191 191 191 194 194 194 194 194 194 194 194 194 194 194 194 194 194 194 194 194 186 2
184 191 191 191 191 191 191 191 191 194 194 194 194 194 194 194 194 194 194 194 194 194 194 194 194 194 186 2
184 191 191 191 191 191 191 191 191 194 194 194 194 194 194 194 194 194 194 194 194 194 194 194 194 194 186 2
184 191 191 191 191 191 191 191 191 194 194 194 194 194 194 194 194 194 194 194 194 194 194 194 194 194 186 2
184 191 191 191 191 191 181 182 183 194 194 194 194 194 194 194 194 194 194 194 194 194 194 194 194 194 170 2
184 191 191 191 191 191 184 185 186 194 194 194 194 194 194 194 194 194 194 194 194 194 194 194 194 194 176 2
184 191 191 191 191 191 187 188 189 194 194 194 194 194 194 194 194 194 194 194 194 194 194 194 194 194 194 1
184 191 191 191 191 191 170 170 170 194 194 194 194 194 194 194 194 194 194 194 194 194 194 194 194 194 186 2
184 191 191 191 191 191 176 176 176 194 194 194 194 194 194 194 194 194 194 194 194 194 194 194 194 194 186 2
184 191 191 191 191 191 191 191 194 194 194 194 194 194 194 194 194 194 194 194 194 194 194 194 194 194 186 2
184 191 191 191 191 191 191 191 194 194 194 194 194 194 194 194 194 194 194 194 194 194 194 194 194 194 186 2
184 191 191 191 191 191 191 191 194 194 194 194 194 194 194 194 194 194 194 194 194 194 194 194 194 194 186 2
184 191 191 191 191 191 181 182 183 194 194 194 194 194 194 194 194 194 194 194 194 194 194 194 194 194 186 2
184 191 191 191 191 191 184 185 186 194 194 194 194 194 194 194 194 194 194 194 194 194 194 194 194 194 186 2
184 191 191 191 191 191 187 188 189 194 194 194 194 194 194 194 194 194 194 194 181 188 188 188 188 188 189 2
184 191 191 191 191 191 170 170 170 194 194 194 194 194 194 194 194 194 194 194 186 2   2   2   2   2   2   2
184 191 191 191 191 191 176 176 176 194 194 194 194 194 194 194 194 194 194 194 186 2   2   2   2   2   2   2
184 191 191 191 191 191 191 191 194 194 194 194 194 194 194 194 194 194 194 194 186 2   2   2   2   2   2   2
184 191 191 191 191 191 191 191 194 194 194 194 194 194 194 194 194 194 194 194 186 2   2   2   2   2   2   2
184 191 191 191 191 191 191 191 194 194 194 194 194 194 194 194 194 194 194 194 186 2   2   2   2   2   2   2
184 191 191 191 191 191 191 191 194 194 194 194 194 194 194 194 194 194 194 194 186 2   2   2   2   2   2   2
187 188 188 191 188 188 188 188 182 194 194 194 194 194 194 194 194 194 194 194 186 2   2   2   2   2   2   2
2   2   2   1   2   2   2   2   184 194 194 194 194 194 194 194 194 194 194 194 186 2   2   2   2   2   2   2
2   2   2   2   2   2   2   2   184 194 194 194 194 194 194 194 194 194 194 194 186 2   2   2   2   2   2   2
2   2   2   2   2   2   2   2   184 194 194 194 194 194 194 194 194 194 194 194 186 2   2   2   2   2   2   2
2   2   2   2   2   2   2   2   187 188 188 188 188 194 188 188 188 188 188 188 189 2   2   2   2   2   2   2
2   2   2   2   2   2   2   2   2   2   2   2   2   1   2   2   2   2   2   2   2   2   2   2   2   2   2   2
2   2   2   2   2   2   2   2   2   2   2   2   2   2   2   2   2   2   2   2   2   2   2   2   2   2   2   2
