39 55
5 12
87
0
0 0
1	1	1	1	1	1	1	1	1	1	1	1	1	1	1	1	1	1	1	1	1	1	1	1	1	1	1	1	1	1	1	1	1	1	1	1	1	1	1
1	1	1	1	1	1	1	1	1	1	1	1	1	1	1	1	1	1	1	1	1	1	1	1	1	1	1	1	1	1	1	1	1	1	1	1	1	1	1
1	1	1	1	1	1	1	1	1	1	1	1	1	1	1	1	1	1	1	1	1	1	1	1	1	1	1	1	1	1	1	1	1	1	1	1	1	1	1
1	1	1	16	16	16	16	16	16	16	16	16	16	16	16	16	16	16	16	16	16	16	16	16	16	16	16	16	16	16	16	16	16	16	16	16	1	1	1
1	1	1	16	17	17	17	17	17	17	17	17	17	17	17	17	17	17	17	16	17	17	17	17	17	17	17	17	17	17	17	17	17	17	17	16	1	1	1
1	1	1	16	17	17	17	17	17	17	17	17	17	17	17	17	17	17	17	16	17	17	17	17	17	17	17	17	17	17	17	17	17	17	17	16	1	1	1
1	1	1	16	17	17	17	17	17	17	17	17	17	17	17	17	17	17	17	16	17	17	17	17	17	17	17	17	17	17	17	17	17	17	17	16	1	1	1
1	1	1	16	27	27	27	27	27	27	27	27	27	27	27	27	27	27	27	16	27	27	27	27	27	27	27	27	27	27	27	27	27	27	27	16	1	1	1
1	1	1	16	27	27	27	27	27	27	27	27	27	27	27	27	27	27	27	16	27	27	27	27	27	27	27	27	27	27	27	27	27	27	27	16	1	1	1
1	1	1	16	27	27	27	27	27	27	27	27	27	27	27	27	27	27	27	16	27	27	27	27	27	27	27	27	27	27	27	27	27	27	27	16	1	1	1
1	1	1	16	27	27	27	27	27	27	27	27	27	27	27	27	27	27	27	16	27	27	27	27	27	27	27	27	27	27	27	27	27	27	27	16	1	1	1
1	1	1	16	27	27	27	27	27	27	27	27	27	27	27	27	27	27	27	16	27	27	27	27	27	27	27	27	27	27	27	27	27	27	27	16	1	1	1
1	1	1	16	16	27	16	16	16	16	16	16	27	27	27	16	16	16	16	16	27	27	27	16	16	16	16	16	16	16	16	16	16	27	16	16	1	1	1
1	1	1	1	1	0	1	1	1	1	1	16	27	27	27	17	17	17	17	17	27	27	27	17	17	17	17	16	1	1	1	1	1	0	1	1	1	1	1
1	1	1	1	1	1	1	1	1	1	1	16	27	27	27	17	17	17	17	17	27	27	27	17	17	17	17	16	1	1	1	1	1	1	1	1	1	1	1
1	1	1	1	1	1	1	1	1	1	1	16	27	27	27	17	17	17	17	17	27	27	27	17	17	17	17	16	1	1	1	1	1	1	1	1	1	1	1
1	1	1	1	1	1	1	1	1	1	1	16	27	27	27	27	27	27	27	27	27	27	27	27	27	27	27	16	1	1	1	1	1	1	1	1	1	1	1
1	1	1	1	1	1	1	1	1	1	16	16	27	27	27	27	27	27	27	27	27	27	27	27	27	27	27	16	16	1	1	1	1	1	1	1	1	1	1
1	1	1	1	1	1	1	1	1	1	17	17	27	27	27	16	27	27	27	27	27	27	27	16	27	27	27	17	17	1	1	1	1	1	1	1	1	1	1
1	1	1	1	1	1	1	1	1	1	17	17	27	27	27	16	27	27	27	27	27	27	27	16	27	27	27	17	17	1	1	1	1	1	1	1	1	1	1
1	1	1	1	1	1	1	1	1	1	17	17	27	27	27	16	27	27	27	27	27	27	27	16	27	27	27	17	17	1	1	1	1	1	1	1	1	1	1
1	1	1	1	1	1	1	1	1	0	27	27	27	27	27	16	27	27	27	27	27	27	27	16	27	27	27	27	27	0	1	1	1	1	1	1	1	1	1
1	1	1	1	1	1	1	1	1	1	16	16	27	27	27	16	27	27	27	27	27	27	27	16	27	27	27	16	16	1	1	1	1	1	1	1	1	1	1
1	1	1	1	1	1	1	1	1	1	1	16	27	27	27	16	27	27	27	27	27	27	27	16	27	27	27	16	1	1	1	1	1	1	1	1	1	1	1
1	1	1	1	1	1	1	1	1	1	1	16	27	27	27	17	27	27	27	27	27	27	27	17	27	27	27	16	1	1	1	1	1	1	1	1	1	1	1
1	1	1	1	1	1	1	1	1	1	16	16	27	27	27	27	27	27	27	27	27	27	27	27	27	27	27	16	16	1	1	1	1	1	1	1	1	1	1
1	1	1	1	1	1	1	1	1	1	17	17	27	27	27	16	27	27	27	27	27	27	27	16	27	27	27	17	17	1	1	1	1	1	1	1	1	1	1
1	1	1	1	1	1	1	1	1	1	17	17	27	27	27	16	27	27	27	27	27	27	27	16	27	27	27	17	17	1	1	1	1	1	1	1	1	1	1
1	1	1	1	1	1	1	1	1	1	17	17	27	27	27	16	27	27	27	27	27	27	27	16	27	27	27	17	17	1	1	1	1	1	1	1	1	1	1
1	1	1	1	1	1	1	1	1	0	27	27	27	27	27	16	27	27	27	27	27	27	27	16	27	27	27	27	27	0	1	1	1	1	1	1	1	1	1
1	1	1	1	1	1	1	1	1	1	16	16	27	27	27	16	27	27	27	27	27	27	27	16	27	27	27	16	16	1	1	1	1	1	1	1	1	1	1
1	1	1	1	1	1	1	1	1	1	1	16	27	27	27	16	27	27	27	27	27	27	27	16	27	27	27	16	1	1	1	1	1	1	1	1	1	1	1
1	1	1	1	1	1	1	1	1	1	1	16	27	27	27	17	27	27	27	27	27	27	27	17	27	27	27	16	1	1	1	1	1	1	1	1	1	1	1
1	1	1	1	1	1	1	1	1	1	16	16	27	27	27	27	27	27	27	27	27	27	27	27	27	27	27	16	16	1	1	1	1	1	1	1	1	1	1
1	1	1	1	1	1	1	1	1	1	17	17	27	27	27	27	27	27	27	16	27	27	27	27	27	27	27	17	17	1	1	1	1	1	1	1	1	1	1
1	1	1	1	1	1	1	1	1	1	17	17	27	27	27	27	27	27	27	16	27	27	27	27	27	27	27	17	17	1	1	1	1	1	1	1	1	1	1
1	1	1	1	1	1	1	1	1	1	17	17	27	27	27	27	27	27	27	16	27	27	27	27	27	27	27	17	17	1	1	1	1	1	1	1	1	1	1
1	1	1	1	1	1	1	1	1	0	27	27	27	27	27	27	27	27	27	16	27	27	27	27	27	27	27	27	27	0	1	1	1	1	1	1	1	1	1
1	1	1	1	1	1	1	1	1	1	16	16	27	27	27	16	16	16	16	16	16	16	16	16	27	27	27	16	16	1	1	1	1	1	1	1	1	1	1
1	1	1	1	1	1	1	1	1	1	1	16	27	27	27	17	17	17	17	16	17	17	17	17	27	27	27	16	1	1	1	1	1	1	1	1	1	1	1
1	1	1	1	1	1	1	1	1	1	1	16	27	27	27	27	27	27	27	16	27	27	27	27	27	27	27	16	1	1	1	1	1	1	1	1	1	1	1
1	1	1	1	1	1	1	1	1	1	1	16	27	27	27	27	27	27	27	16	27	27	27	27	27	27	27	16	1	1	1	1	1	1	1	1	1	1	1
1	1	1	1	16	16	16	16	16	16	16	16	27	27	27	27	27	27	27	16	27	27	27	27	27	27	27	16	16	16	16	16	16	16	16	1	1	1	1
1	1	1	1	16	17	17	17	17	17	17	17	27	27	27	27	27	27	27	17	27	27	27	27	27	27	27	17	17	17	17	17	17	17	16	1	1	1	1
1	1	1	1	16	17	17	17	17	17	17	17	27	27	27	27	27	27	27	27	27	27	27	27	27	27	27	17	17	17	17	17	17	17	16	1	1	1	1
1	1	1	1	16	0	17	17	17	17	17	17	27	27	27	27	27	27	27	27	27	27	27	27	27	27	27	17	17	17	17	17	17	0	16	1	1	1	1
1	1	1	1	16	27	27	27	27	27	27	27	27	27	27	27	27	27	27	27	27	27	27	27	27	27	27	27	27	27	27	27	27	27	16	1	1	1	1
1	1	1	1	16	27	27	27	27	27	27	27	27	27	27	16	16	16	16	16	16	16	16	16	27	27	27	27	27	27	27	27	27	27	16	1	1	1	1
1	1	1	1	16	27	27	27	27	27	27	27	27	27	27	16	1	1	1	1	1	1	1	16	27	27	27	27	27	27	27	27	27	27	16	1	1	1	1
1	1	1	1	16	27	27	27	27	27	27	27	27	27	27	16	1	1	1	1	1	1	1	16	27	27	27	27	27	27	27	27	27	27	16	1	1	1	1
1	1	1	1	16	27	27	27	27	27	27	27	27	27	27	16	1	1	1	1	1	1	1	16	27	27	27	27	27	27	27	27	27	27	16	1	1	1	1
1	1	1	1	16	16	16	16	16	16	16	16	16	16	16	16	1	1	1	1	1	1	1	16	16	16	16	16	16	16	16	16	16	16	16	1	1	1	1
1	1	1	1	1	1	1	1	1	1	1	1	1	1	1	1	1	1	1	1	1	1	1	1	1	1	1	1	1	1	1	1	1	1	1	1	1	1	1
1	1	1	1	1	1	1	1	1	1	1	1	1	1	1	1	1	1	1	1	1	1	1	1	1	1	1	1	1	1	1	1	1	1	1	1	1	1	1
1	1	1	1	1	1	1	1	1	1	1	1	1	1	1	1	1	1	1	1	1	1	1	1	1	1	1	1	1	1	1	1	1	1	1	1	1	1	1
153 5 13
154 33 13
155 29 21
156 29 29
157 29 37
158 9 21
159 9 29
160 9 37
161 5 45
162 33 45
126 13 20
101 14 20
126 13 23
101 14 23
126 13 28
101 14 28
126 13 31
101 14 31
126 16 20
101 17 20
126 16 23
101 17 23
126 16 28
101 17 28
126 16 31
101 17 31
126 21 20
101 22 20
126 21 23
101 22 23
126 21 28
101 22 28
126 21 31
101 22 31
126 24 20
101 25 20
126 24 23
101 25 23
126 24 28
101 25 28
126 24 31
101 25 31
224 13 19
225 13 22
226 13 27
227 13 30
228 16 19
229 16 22
230 16 27
231 16 30
232 21 19
233 21 22
234 21 27
235 21 30
236 24 19
237 24 22
238 24 27
239 24 30
240 23 42
241 9 46
214 15 16
214 15 17
214 18 23
214 19 23
214 20 23
214 26 23
212 19 46
212 19 45
212 19 44
212 24 37
212 25 36
212 26 35
213 12 23
213 14 38
213 13 38
213 12 38
213 18 33
213 18 32
213 10 29
213 19 32
213 20 32
213 20 33
213 28 29
213 28 37
213 26 46
213 25 46
213 24 46