27 29
12 15
3
0 0
2   2   2   2   2   2   2   2   2   2   2   2   2   2   2   2   2   2   2   2   2   2   2   2   2   2   2
2   181 188 188 188 188 188 188 188 188 188 188 188 188 188 188 188 188 188 188 188 188 188 188 188 183 2
2   186 170 170 170 170 170 170 170 170 170 170 170 170 170 170 170 170 170 170 170 170 170 170 170 184 2
2   186 176 176 176 176 176 176 176 176 176 176 176 176 176 176 176 176 176 176 176 176 176 176 176 184 2
2   186 191 191 191 191 191 191 191 191 191 191 191 191 191 191 191 191 191 191 191 191 191 191 191 184 2
2   186 191 191 191 191 191 191 191 191 191 191 191 191 191 191 191 191 191 191 191 191 191 191 191 184 2
2   186 191 191 191 191 191 191 191 191 191 191 191 191 191 191 191 191 191 191 191 191 191 191 191 184 2
2   186 191 191 191 191 191 191 191 186 191 191 191 191 191 191 191 191 191 191 191 191 191 191 191 184 2
2   186 191 191 191 191 191 191 191 186 191 191 191 191 191 191 191 191 191 191 191 191 191 191 191 184 2
2   170 191 191 191 191 191 191 191 186 191 191 191 191 191 191 191 191 191 191 191 191 191 191 191 184 2
2   176 191 191 191 191 191 191 191 186 191 191 191 191 191 191 191 191 191 191 191 191 191 191 191 170 2
1   191 191 191 191 191 191 191 191 186 186 186 186 183 191 191 191 191 191 191 191 191 191 191 191 176 2
2   186 191 191 191 191 191 191 191 170 170 170 170 184 191 191 191 191 191 191 191 191 191 191 191 191 1
2   186 191 191 191 191 191 191 191 176 176 176 176 184 191 191 191 191 191 191 191 191 191 191 191 184 2
2   186 191 191 191 191 191 191 191 191 191 191 191 184 191 191 191 191 191 191 191 191 191 191 191 184 2
2   186 191 191 191 191 191 191 191 191 191 191 191 184 191 191 191 191 191 191 191 191 191 191 191 184 2
2   186 191 191 191 191 191 191 191 191 191 191 191 184 191 191 191 191 191 191 191 191 191 191 191 184 2
2   187 188 188 188 188 188 188 188 185 191 191 191 184 188 188 188 188 188 188 188 188 188 188 188 189 2
2   2   2   2   2   2   2   2   2   186 191 191 191 184 2   2   2   2   2   2   2   2   2   2   2   2   2
2   2   2   2   2   2   2   2   2   186 191 191 191 184 2   2   2   2   2   2   2   2   2   2   2   2   2
2   2   2   2   2   181 188 188 188 189 191 191 191 184 2   2   2   2   2   2   2   2   2   2   2   2   2
2   2   2   2   2   188 170 170 170 170 191 191 191 184 2   2   2   2   2   2   2   2   2   2   2   2   2
2   2   2   2   2   170 176 176 176 176 191 191 191 184 2   2   2   2   2   2   2   2   2   2   2   2   2
2   2   2   2   2   176 191 191 191 191 191 191 191 184 2   2   2   2   2   2   2   2   2   2   2   2   2
2   2   2   2   1   191 191 191 191 191 191 191 191 184 2   2   2   2   2   2   2   2   2   2   2   2   2
2   2   2   2   2   183 191 191 191 191 191 191 191 184 2   2   2   2   2   2   2   2   2   2   2   2   2
2   2   2   2   2   187 188 188 188 188 188 188 188 189 2   2   2   2   2   2   2   2   2   2   2   2   2
2   2   2   2   2   2   2   2   2   2   2   2   2   2   2   2   2   2   2   2   2   2   2   2   2   2   2
2   2   2   2   2   2   2   2   2   2   2   2   2   2   2   2   2   2   2   2   2   2   2   2   2   2   2
222 0 11
223 4 24
187 26 12