46 82
22 58
1
0 0
2   2   2   2   2   2   2   2   2   2   2   2   2   2   2   181 188 188 188 188 188 188 1   188 188 188 188 182 188 183 2   2   2   2   2   2   2   2   2   2   2   2   2   2   2   2
2   2   2   2   2   2   2   2   2   2   2   2   2   2   2   184 170 170 170 170 170 170 28  170 170 170 170 170 170 186 2   2   2   2   2   2   2   2   2   2   2   2   2   2   2   2
2   2   2   2   2   2   2   2   2   2   2   2   2   2   2   184 176 176 176 176 176 176 31  176 176 176 176 176 176 186 2   2   2   2   2   2   2   2   2   2   2   2   2   2   2   2
2   2   2   2   2   2   2   2   2   2   2   2   2   2   2   184 27  28  28  28  28  28  31  28  28  28  28  28  29  186 2   2   2   2   2   2   2   2   2   2   2   2   2   2   2   2
2   2   2   2   2   2   2   2   2   2   2   2   2   2   2   184 30  31  31  31  31  31  31  31  31  31  31  31  32  186 2   2   2   2   2   2   2   2   2   2   2   2   2   2   2   2
2   2   2   2   2   2   2   2   2   2   2   2   2   2   2   184 30  31  31  31  31  31  31  31  31  31  31  31  32  186 2   2   2   2   2   2   2   2   2   2   2   2   2   2   2   2
2   2   2   2   2   2   2   2   2   2   2   2   2   2   2   184 30  31  31  31  31  31  31  31  31  31  31  31  32  186 2   2   2   2   2   2   2   2   2   2   2   2   2   2   2   2
2   2   2   2   2   2   2   2   2   2   2   2   2   2   2   184 30  31  31  31  31  31  31  31  31  31  31  31  32  186 2   2   2   2   2   2   2   2   2   2   2   2   2   2   2   2
2   2   2   2   2   2   2   2   2   2   2   2   2   2   2   184 30  34  34  34  31  31  31  31  31  34  34  34  32  186 2   2   2   2   2   2   2   2   2   2   2   2   2   2   2   2
2   2   2   2   2   2   2   2   2   2   2   2   181 188 188 188 188 188 188 183 30  31  31  31  32  181 188 188 188 188 188 188 188 188 188 188 188 188 188 188 183 2   2   2   2   2
2   2   2   2   2   2   2   2   2   2   2   2   186 170 170 170 170 170 170 170 30  31  31  31  32  170 170 170 170 170 170 170 170 170 170 170 170 170 170 170 186 2   2   2   2   2
2   2   2   181 188 188 188 188 188 188 188 188 189 176 176 176 176 176 176 176 30  31  31  31  32  176 176 176 176 176 176 176 176 176 176 176 176 176 176 176 186 2   2   2   2   2
2   2   2   184 170 170 170 170 170 170 170 170 170 27  28  28  28  28  28  28  31  31  31  31  31  28  28  28  28  28  28  28  28  28  28  28  28  28  28  29  186 2   2   2   2   2
2   2   2   184 176 176 176 176 176 176 176 176 176 30  31  31  31  31  31  31  31  31  31  31  31  31  31  31  31  31  31  31  31  31  31  31  31  31  31  32  186 2   2   2   2   2
2   2   2   184 27  28  28  28  28  28  28  28  28  31  31  31  31  34  34  34  34  34  34  34  34  34  34  34  34  34  34  31  31  31  31  31  31  31  31  32  186 2   2   2   2   2
2   2   2   184 30  31  31  31  31  31  31  31  31  31  31  31  32  181 182 182 182 182 182 182 182 182 182 182 182 182 183 30  31  31  31  31  31  31  31  32  186 2   2   2   2   2
2   2   2   184 30  31  31  31  31  31  31  31  31  31  31  31  32  185 185 185 185 185 185 185 185 185 185 185 185 185 186 30  31  31  31  31  31  31  31  32  186 2   2   2   2   2
2   2   2   184 30  31  31  31  31  31  31  31  31  31  31  31  32  185 185 185 185 185 185 185 185 185 185 185 185 185 186 30  31  31  31  31  31  31  31  32  170 2   2   2   2   2
2   2   2   184 30  31  31  31  31  31  31  31  31  31  31  31  32  185 185 185 185 185 185 185 185 185 185 185 185 185 186 30  31  31  31  31  31  31  31  32  176 2   2   2   2   2
2   2   2   184 30  31  31  31  31  31  31  31  31  34  34  34  35  185 185 185 185 185 185 185 185 185 185 185 185 185 186 30  31  31  31  31  31  31  31  31  28  2   2   2   2   2
2   2   2   184 30  31  31  31  31  31  31  31  32  182 182 182 182 185 185 185 185 185 185 185 185 185 185 185 185 185 186 30  31  31  31  31  31  31  31  32  186 2   2   2   2   2
2   2   2   188 30  31  31  31  31  31  31  31  32  185 185 185 185 185 185 185 185 185 185 185 185 185 185 185 185 185 186 30  31  31  31  31  31  31  31  32  186 2   2   2   2   2
2   2   1   170 30  31  31  31  34  34  34  34  35  185 185 185 185 185 185 185 185 185 185 185 185 185 185 185 185 185 186 30  31  31  31  31  31  31  31  32  186 2   2   2   2   2
2   2   2   176 30  31  31  32  188 188 188 188 188 185 185 185 185 185 185 185 185 185 185 185 185 185 185 185 185 185 186 30  31  31  31  31  31  31  31  32  186 2   2   2   2   2
2   2   2   28  31  31  31  32  170 170 170 170 170 185 185 185 185 185 185 185 185 185 185 185 185 185 185 185 185 185 186 30  31  31  31  31  31  31  31  32  186 2   2   2   2   2
2   2   2   184 30  31  31  32  176 176 176 176 176 185 185 185 185 185 185 185 185 185 185 185 185 185 185 185 185 185 186 30  31  31  31  34  34  34  34  35  186 2   2   2   2   2
2   2   2   184 30  31  31  31  28  28  28  28  29  185 185 185 185 185 185 185 185 185 185 185 185 185 185 185 185 185 186 30  31  31  32  181 188 188 188 188 189 2   2   2   2   2
2   2   2   184 30  31  31  31  31  31  31  31  32  185 185 185 185 185 185 185 185 185 185 185 185 185 185 185 185 185 186 30  31  31  32  186 2   2   2   2   2   2   2   2   2   2
2   2   2   184 30  31  31  31  31  31  31  31  32  185 185 185 185 185 185 185 185 185 185 185 185 185 185 185 185 185 186 30  31  31  32  186 2   2   2   2   2   2   2   2   2   2
2   2   2   184 30  31  31  31  31  31  31  31  32  185 185 185 185 185 185 185 185 185 185 185 185 185 185 185 185 185 186 30  31  31  32  186 2   2   2   2   2   2   2   2   2   2
2   2   2   184 30  31  31  31  31  31  31  31  32  185 185 185 185 185 185 185 185 185 185 185 185 185 185 185 185 185 186 30  31  31  32  186 2   2   2   2   2   2   2   2   2   2
2   2   2   184 30  31  31  31  31  31  31  31  32  185 185 185 185 185 185 185 185 185 185 185 185 185 185 185 185 185 186 30  31  31  32  186 2   2   2   2   2   2   2   2   2   2
2   2   2   184 33  34  34  34  31  34  34  34  35  185 185 185 185 185 185 185 185 185 185 185 185 185 185 185 185 185 186 30  31  31  32  186 2   2   2   2   2   2   2   2   2   2
2   2   2   187 188 188 185 185 31  185 185 185 185 185 185 185 185 185 185 185 185 185 185 185 185 185 185 185 185 185 186 30  31  31  32  186 2   2   2   2   2   2   2   2   2   2
2   2   2   2   2   2   185 188 31  188 184 185 185 185 185 185 185 185 185 185 185 185 185 185 185 185 185 185 185 185 186 30  31  31  32  186 2   2   2   2   2   2   2   2   2   2
2   2   2   2   2   2   184 170 31  170 184 185 185 185 185 185 185 185 185 185 185 185 185 185 185 185 185 185 185 185 186 30  31  31  32  186 2   2   2   2   2   2   2   2   2   2
2   2   2   2   2   181 184 176 31  176 184 185 185 185 185 185 185 185 185 185 185 185 185 185 185 185 185 185 185 185 186 30  31  31  32  188 188 183 2   2   2   2   2   2   2   2
2   2   2   2   2   184 170 27  31  29  184 185 185 185 186 188 188 188 188 188 188 188 188 188 188 188 188 188 188 188 188 30  31  31  32  170 170 186 2   2   2   2   2   2   2   2
2   2   2   2   2   184 176 30  31  32  184 185 185 185 186 170 170 170 170 170 170 170 170 170 170 170 170 170 170 170 170 30  31  31  32  176 176 186 2   2   2   2   2   2   2   2
2   2   2   2   2   184 27  31  31  32  184 185 185 185 186 176 176 176 176 176 176 176 176 176 176 176 176 176 176 176 176 30  31  31  31  28  29  186 2   2   2   2   2   2   2   2
2   2   2   2   2   184 30  31  31  32  184 185 185 185 186 27  28  28  28  28  28  28  28  28  28  28  28  28  28  28  28  31  31  31  31  31  32  186 2   2   2   2   2   2   2   2
2   2   2   2   2   184 30  31  31  32  184 185 185 185 186 30  31  31  31  31  31  31  31  31  31  31  31  31  31  31  31  31  31  31  31  31  32  186 2   2   2   2   2   2   2   2
2   2   2   2   2   184 30  31  31  32  184 185 185 185 186 30  31  31  31  31  31  31  31  31  31  31  31  31  31  31  31  31  31  31  31  31  32  186 2   2   2   2   2   2   2   2
2   2   2   2   2   184 30  31  31  32  184 185 185 185 186 30  31  31  31  31  31  31  31  31  31  31  31  31  31  31  34  31  31  31  31  31  32  186 2   2   2   2   2   2   2   2
2   2   2   2   2   184 30  31  31  32  184 185 185 185 186 30  31  31  31  31  31  31  31  31  31  31  31  31  31  32  186 30  31  31  31  31  32  186 2   2   2   2   2   2   2   2
2   2   2   2   2   184 30  31  31  32  187 188 188 188 189 30  31  31  31  31  31  31  31  31  31  31  31  31  31  32  186 30  31  31  31  31  32  186 2   2   2   2   2   2   2   2
2   2   2   2   2   184 30  31  31  32  170 170 170 170 170 30  31  31  31  31  31  31  31  31  31  31  31  31  31  32  186 30  31  31  31  31  32  186 2   2   2   2   2   2   2   2
2   2   2   2   2   184 30  31  31  32  176 176 176 176 176 30  31  31  31  31  31  31  31  31  31  31  31  31  31  32  186 30  31  31  31  31  32  186 2   2   2   2   2   2   2   2
2   2   2   2   2   184 30  31  31  31  28  28  28  28  28  31  31  31  31  31  31  31  31  31  31  31  31  31  31  32  186 30  31  31  31  31  32  186 2   2   2   2   2   2   2   2
2   2   2   2   2   184 30  31  31  31  31  31  31  31  31  31  31  31  31  31  31  31  31  31  31  31  31  31  31  32  186 33  34  34  34  31  32  186 2   2   2   2   2   2   2   2
2   2   2   2   2   184 30  31  31  31  31  31  31  31  31  31  31  31  31  31  31  31  31  31  31  31  31  31  31  32  186 182 182 182 183 30  32  186 2   2   2   2   2   2   2   2
2   2   2   2   2   184 30  31  31  31  34  34  34  34  34  34  34  34  34  34  31  31  31  31  31  34  34  34  34  35  186 2   2   2   184 30  32  186 2   2   2   2   2   2   2   2
2   2   2   181 188 189 30  31  31  32  181 188 188 188 188 188 188 188 188 183 30  31  31  31  32  181 188 188 188 188 189 2   2   181 189 30  32  186 2   2   2   2   2   2   2   2
2   2   2   184 170 170 30  31  31  32  186 2   2   2   2   2   2   2   2   184 30  31  31  31  32  186 2   2   2   2   2   2   2   184 170 30  32  186 2   2   2   2   2   2   2   2
2   2   2   184 176 176 30  31  31  32  186 2   2   2   2   2   2   2   2   184 30  31  31  31  32  186 2   2   2   2   2   2   2   184 176 30  32  186 2   2   2   2   2   2   2   2
2   2   2   184 27  28  31  31  31  32  186 2   2   2   2   2   2   2   2   184 30  31  31  31  32  186 2   2   2   2   2   2   2   184 27  31  32  186 2   2   2   2   2   2   2   2
2   2   2   184 30  31  31  31  31  32  186 2   2   2   2   2   2   2   2   184 30  31  31  31  32  186 2   2   2   2   2   2   2   184 33  31  35  186 2   2   2   2   2   2   2   2
2   2   2   184 30  31  31  31  31  32  186 2   2   2   2   2   2   2   2   184 33  34  31  34  35  186 2   2   2   2   2   2   2   187 182 34  182 189 2   2   2   2   2   2   2   2
2   2   2   184 30  31  31  31  31  32  186 2   2   2   2   2   2   2   2   187 188 188 34  188 188 189 2   2   2   2   2   2   2   2   2   1   2   2   2   2   2   2   2   2   2   2
2   2   2   184 30  31  31  31  31  32  186 2   2   2   2   2   2   2   2   2   2   2   1   2   2   2   2   2   2   2   2   2   2   2   2   2   2   2   2   2   2   2   2   2   2   2
2   2   2   184 30  31  31  31  31  32  186 2   2   2   2   2   2   2   2   2   2   2   2   2   2   2   2   2   2   2   2   2   2   2   2   2   2   2   2   2   2   2   2   2   2   2
2   2   2   184 30  31  31  31  31  32  186 2   2   2   2   2   2   2   2   2   2   2   2   2   2   2   2   2   2   2   2   2   2   2   2   2   2   2   2   2   2   2   2   2   2   2
2   2   2   184 30  31  31  31  31  32  186 2   2   2   2   2   2   2   2   2   2   2   2   2   2   2   2   2   2   2   2   2   2   2   2   2   2   2   2   2   2   2   2   2   2   2
2   2   2   184 30  31  31  31  31  32  186 2   2   2   2   2   2   2   2   2   2   2   2   2   2   2   2   2   2   2   2   2   2   2   2   2   2   2   2   2   2   2   2   2   2   2
2   2   2   184 30  31  31  31  31  32  187 188 183 2   2   2   2   2   2   2   2   2   2   2   2   2   2   2   2   2   2   2   2   2   2   2   2   2   2   2   2   2   2   2   2   2
2   2   2   184 30  31  31  31  31  32  170 170 186 2   2   2   2   2   2   2   2   2   2   2   2   2   2   2   2   2   2   2   2   2   2   2   2   2   2   2   2   2   2   2   2   2
2   2   2   184 30  31  31  31  31  32  176 176 186 2   2   2   2   2   2   2   2   2   2   2   2   2   2   2   2   2   2   2   2   2   2   2   2   2   2   2   2   2   2   2   2   2
2   2   2   184 30  31  31  31  31  31  28  29  186 188 188 188 188 188 188 188 188 188 188 188 188 185 188 188 188 188 188 186 2   2   2   2   2   2   2   2   2   2   2   2   2   2
2   2   2   184 30  31  31  31  31  31  31  32  186 170 170 170 170 170 170 170 170 170 170 170 170 186 170 170 170 170 170 186 2   2   2   2   2   2   2   2   2   2   2   2   2   2
2   2   2   184 30  31  31  31  31  31  31  32  186 176 176 176 176 176 176 176 176 176 176 176 176 186 176 176 176 176 176 186 2   2   2   2   2   2   2   2   2   2   2   2   2   2
2   2   2   184 30  31  31  31  31  31  31  32  188 27  28  28  28  28  28  28  28  28  28  28  29  186 27  28  28  28  29  186 2   2   2   2   2   2   2   2   2   2   2   2   2   2
2   2   2   184 30  31  31  31  31  31  31  32  170 30  31  31  31  31  31  31  31  31  31  31  32  170 30  31  31  31  32  170 2   2   2   2   2   2   2   2   2   2   2   2   2   2
2   2   2   184 30  31  31  31  31  31  31  32  176 30  31  31  31  31  31  31  31  31  31  31  32  176 30  31  31  31  32  176 2   2   2   2   2   2   2   2   2   2   2   2   2   2
2   2   2   184 30  31  31  31  31  31  31  31  31  31  31  31  31  31  31  31  31  31  31  31  31  31  31  31  31  31  31  31  1   2   2   2   2   2   2   2   2   2   2   2   2   2
2   2   2   184 30  31  31  31  31  31  31  31  186 30  31  31  31  31  31  31  31  31  31  31  32  186 30  31  31  31  32  186 2   2   2   2   2   2   2   2   2   2   2   2   2   2
2   2   2   184 33  34  34  34  34  34  34  34  186 30  31  31  31  31  31  31  31  31  31  31  32  186 33  31  34  34  35  186 2   2   2   2   2   2   2   2   2   2   2   2   2   2
2   2   2   187 182 182 182 182 182 182 182 182 186 30  31  31  31  31  31  31  31  31  31  31  32  186 188 188 188 188 188 189 2   2   2   2   2   2   2   2   2   2   2   2   2   2
2   2   2   2   2   2   2   2   2   2   2   2   184 33  34  34  34  34  34  34  34  34  34  34  35  186 2   2   2   2   2   2   2   2   2   2   2   2   2   2   2   2   2   2   2   2
2   2   2   2   2   2   2   2   2   2   2   2   187 188 188 188 188 188 188 188 188 188 188 188 188 189 2   2   2   2   2   2   2   2   2   2   2   2   2   2   2   2   2   2   2   2
2   2   2   2   2   2   2   2   2   2   2   2   2   2   2   2   2   2   2   2   2   2   2   2   2   2   2   2   2   2   2   2   2   2   2   2   2   2   2   2   2   2   2   2   2   2
2   2   2   2   2   2   2   2   2   2   2   2   2   2   2   2   2   2   2   2   2   2   2   2   2   2   2   2   2   2   2   2   2   2   2   2   2   2   2   2   2   2   2   2   2   2
2   2   2   2   2   2   2   2   2   2   2   2   2   2   2   2   2   2   2   2   2   2   2   2   2   2   2   2   2   2   2   2   2   2   2   2   2   2   2   2   2   2   2   2   2   2
4 22 59

