24 20
8 12
2
0
0 0
1	1	1	1	1	1	1	1	1	1	1	1	1	1	1	1	1	1	1	1	1	1	1	1
1	1	1	1	1	1	1	1	1	1	1	1	1	1	1	1	1	1	1	1	1	1	1	1
1	1	1	1	1	1	1	1	1	1	1	1	1	1	1	1	1	1	1	1	1	1	1	1
1	1	1	10	10	10	10	10	10	10	10	10	10	10	10	10	10	10	10	10	10	1	1	1
1	1	1	10	11	11	11	11	11	11	11	11	11	11	11	11	11	11	11	11	10	1	1	1
1	1	1	10	11	11	11	11	11	11	11	11	11	11	11	11	11	11	11	11	10	1	1	1
1	1	1	10	11	11	11	11	11	11	11	11	11	11	11	11	11	11	11	11	10	1	1	1
1	1	1	10	4	4	4	4	4	4	4	4	4	4	4	4	4	4	4	4	10	1	1	1
1	1	1	10	4	4	4	4	4	4	4	4	4	4	4	4	4	4	4	4	10	1	1	1
1	1	1	10	4	4	4	4	4	4	4	4	4	4	4	4	4	4	4	4	10	1	1	1
1	1	1	10	4	4	4	4	4	4	4	4	4	4	4	4	4	4	4	4	10	1	1	1
1	1	1	10	4	4	4	4	4	4	4	4	4	4	4	4	4	4	4	4	10	1	1	1
1	1	1	10	10	10	10	10	4	10	10	10	10	10	10	4	4	4	4	4	10	1	1	1
1	1	1	1	1	1	1	1	0	1	1	1	1	1	10	4	4	4	4	4	10	1	1	1
1	1	1	1	1	1	1	1	1	1	1	1	1	1	10	4	4	4	4	4	10	1	1	1
1	1	1	1	1	1	1	1	1	1	1	1	1	1	10	10	10	4	10	10	10	1	1	1
1	1	1	1	1	1	1	1	1	1	1	1	1	1	1	1	1	0	1	1	1	1	1	1
1	1	1	1	1	1	1	1	1	1	1	1	1	1	1	1	1	1	1	1	1	1	1	1
1	1	1	1	1	1	1	1	1	1	1	1	1	1	1	1	1	1	1	1	1	1	1	1
1	1	1	1	1	1	1	1	1	1	1	1	1	1	1	1	1	1	1	1	1	1	1	1
310 8 13
311 17 16
1