



2   2   126 133 133 133 133 133 133 133 133 133 133 128 2
2   2   134 115 115 115 115 115 115 115 115 115 115 115 2
2   2   131 121 121 121 121 1   121 121 121 121 121 121 2
2   2   131 27  28  28  28  28  28  28  28  28  29  37  2
2   2   131 30  31  31  31  31  31  31  31  31  31  29  1  
2   2   131 30  31  31  31  31  31  31  31  32  126 134 2
2   2   131 30  31  31  31  31  31  31  31  32  131 2   2
2   2   131 30  31  31  31  31  31  31  31  32  131 2   2
2   2   131 30  31  31  31  31  31  31  31  32  131 2   2
2   2   131 30  31  31  31  31  31  31  31  32  131 2   2
2   2   131 30  31  31  31  31  31  31  31  32  131 2   2
2   2   115 30  31  31  31  31  31  31  31  32  131 2   2
2   2   121 30  31  31  31  31  31  31  31  32  131 2   2
2   1   28  31  31  31  31  31  31  31  31  32  131 2   2
2   2   131 30  31  31  31  31  31  31  31  32  131 2   2
2   2   131 30  31  31  31  31  31  31  31  32  131 2   2
2   2   131 30  31  31  31  31  31  31  31  32  131 2   2
2   2   131 33  34  34  34  34  34  34  34  35  131 2   2
2   2   132 127 127 127 127 127 127 127 127 127 134 2   2
2   2   2   2   2   2   2   2   2   2   2   2   2   2   2
2   2   2   2   2   2   2   2   2   2   2   2   2   2   2
2   2   2   2   2   2   2   2   2   2   2   2   2   2   2
