22 44
12 7
3
30
0 0
1	1	1	1	1	1	1	1	1	1	1	1	1	1	1	1	1	1	1	1	1	1
1	1	1	1	1	1	1	1	1	1	1	1	1	1	1	1	1	1	1	1	1	1
1	1	1	1	1	1	1	1	1	1	1	1	1	1	1	1	1	1	1	1	1	1
1	1	1	1	1	1	1	16	16	16	16	16	1	1	1	1	1	1	1	1	1	1
1	1	1	1	1	1	1	16	17	17	17	17	1	1	1	1	1	1	1	1	1	1
1	1	1	1	1	1	1	16	17	17	17	17	1	1	1	1	1	1	1	1	1	1
1	1	1	1	1	1	1	16	17	17	17	17	1	1	1	1	1	1	1	1	1	1
1	1	1	1	1	1	1	16	14	14	14	14	0	1	1	1	1	1	1	1	1	1
1	1	1	1	1	1	1	16	14	14	14	1	1	1	1	1	1	1	1	1	1	1
1	1	1	1	1	1	1	16	14	14	14	1	1	1	1	1	1	1	1	1	1	1
1	1	1	1	1	1	1	16	14	14	14	21	1	1	1	1	1	1	1	1	1	1
1	1	1	1	1	1	1	16	16	16	16	1	21	1	1	1	1	1	1	1	1	1
1	1	1	1	1	1	1	1	1	1	1	1	1	21	1	1	1	1	1	1	1	1
1	1	1	1	1	1	1	1	1	1	1	1	1	1	21	1	1	1	1	1	1	1
1	1	1	1	1	1	1	1	1	1	1	1	1	1	1	21	14	14	14	1	1	1
1	1	1	1	1	1	1	1	1	1	1	1	1	1	1	1	14	14	14	1	1	1
1	1	1	1	1	1	1	1	1	1	1	1	1	1	1	1	14	14	14	1	1	1
1	1	1	1	1	1	1	1	1	1	1	1	1	1	1	20	14	14	14	1	1	1
1	1	1	1	1	1	1	1	1	1	1	1	1	1	20	1	1	1	1	1	1	1
1	1	1	1	1	1	1	1	1	1	1	1	1	20	1	1	1	1	1	1	1	1
1	1	1	1	1	1	1	1	1	1	1	1	20	1	1	1	1	1	1	1	1	1	
1	1	1	1	1	1	1	1	7	7	7	20	1	1	1	1	1	1	1	1	1	1
1	1	1	1	1	1	1	1	7	7	7	1	1	1	1	1	1	1	1	1	1	1
1	1	1	1	1	1	1	1	18	18	18	1	1	1	1	1	1	1	1	1	1	1
1	1	1	1	1	1	1	1	18	18	18	1	1	1	1	1	1	1	1	1	1	1
1	1	1	1	1	1	1	1	18	18	18	1	1	1	1	1	1	1	1	1	1	1
1	1	1	16	16	16	16	16	18	18	18	16	16	16	16	16	1	1	1	1	1	1
1	1	1	16	17	17	17	17	18	18	18	17	17	17	17	16	1	1	1	1	1	1
1	1	1	16	17	17	17	17	18	18	18	17	17	17	17	16	1	1	1	1	1	1
1	1	1	16	17	17	17	17	18	18	18	17	17	17	17	16	1	1	1	1	1	1
1	1	1	16	7	7	7	7	7	7	7	7	7	7	7	16	1	1	1	1	1	1
1	1	1	16	7	7	7	7	7	7	7	7	7	7	7	16	1	1	1	1	1	1
1	1	1	16	7	7	7	7	7	7	7	7	7	7	7	16	1	1	1	1	1	1
1	1	1	16	7	7	7	7	7	7	7	7	7	7	7	16	1	1	1	1	1	1
1	1	1	16	7	7	7	7	7	7	7	7	7	7	7	16	1	1	1	1	1	1
1	1	1	16	7	7	7	7	7	7	7	7	7	7	7	16	1	1	1	1	1	1
1	1	1	16	7	7	7	7	7	7	7	7	7	7	7	16	1	1	1	1	1	1
1	1	1	16	7	7	7	7	7	7	7	7	7	7	7	16	1	1	1	1	1	1
1	1	1	16	7	7	7	7	7	7	7	7	7	7	7	16	1	1	1	1	1	1
1	1	1	16	7	7	7	7	7	7	7	7	7	7	7	16	1	1	1	1	1	1
1	1	1	16	16	16	16	16	16	16	16	16	16	16	16	16	1	1	1	1	1	1
1	1	1	1	1	1	1	1	1	1	1	1	1	1	1	1	1	1	1	1	1	1
1	1	1	1	1	1	1	1	1	1	1	1	1	1	1	1	1	1	1	1	1	1
1	1	1	1	1	1	1	1	1	1	1	1	1	1	1	1	1	1	1	1	1	1
279 12 7
341 6 36
342 13 30
32 352 640
32 384 608
32 416 576
32 448 544
32 480 512
33 352 672
33 384 640
33 416 608
33 448 576
33 480 544
34 352 704
34 384 672
34 416 640
34 448 608
34 480 576
36 352 288
36 384 320
36 416 352
36 448 384
36 480 416
37 352 320
37 384 352
37 416 384
37 448 416
37 480 448
38 352 352
38 384 384
38 416 416
38 448 448
38 480 480
5