11 15
5 10
5
2
0 0
1	1	1	1	1	1	1	1	1	1	1
1	1	1	1	1	1	1	1	1	1	1
1	1	1	1	1	1	1	1	1	1	1
1	1	1   10	10	10	10	10	1 	1	1
1	1	1	10	11	11	11	10	1	1	1
1	1	1	10	11	11	11	10	1	1	1
1	1	1	10	11	11	11	10	1	1	1
1	1	1	10	7	7	7	10	1	1	1
1	1	1	10	7	7	7	10	1	1	1
1	1	1	10	7	7	7	10	1	1	1
1	1	1	10	10	7	10	10	1	1	1
1	1	1	1	1	0	1	1	1	1	1
1	1	1	1	1	1	1	1	1	1	1
1	1	1	1	1	1	1	1	1	1	1
1	1	1	1	1	1	1	1	1	1	1
102 5 8
101 4 7
101 5 7
101 6 7
290 5 11
69 128 192
70 192 192
4