18 20
13 11
7
0
0 0
1	1	1	1	1	1	1	1	1	1	1	1	1	1	1	1	1	1
1	1	1	1	1	1	1	1	1	1	1	1	1	1	1	1	1	1
1	1	1	1	1	1	1	1	1	1	1	1	1	1	1	1	1	1
1	1	1	16	16	16	16	16	16	16	16	16	16	16	1	1	1	1
1	1	1	16	17	17	17	17	17	17	17	17	17	16	1	1	1	1
1	1	1	16	17	17	17	17	17	17	17	17	17	16	1	1	1	1
1	1	1	16	17	17	17	17	17	17	17	17	17	16	1	1	1	1
1	1	1	16	14	14	14	14	14	14	14	14	14	16	1	1	1	1
1	1	1	16	14	14	14	14	14	14	14	14	14	17	1	1	1	1
1	1	1	16	14	14	14	14	14	14	14	14	14	17	1	1	1	1
1	1	1	16	14	14	14	14	14	14	14	14	14	17	1	1	1	1
1	1	1	16	14	14	14	14	14	14	14	14	14	14	0	1	1	1
1	1	1	16	14	14	14	14	14	14	14	14	14	16	1	1	1	1
1	1	1	16	14	14	14	14	14	14	14	14	14	16	1	1	1	1
1	1	1	16	14	14	14	14	14	14	14	14	14	16	1	1	1	1
1	1	1	16	14	14	14	14	14	14	14	14	14	16	1	1	1	1
1	1	1	16	16	16	16	16	16	16	16	16	16	16	1	1	1	1
1	1	1	1	1	1	1	1	1	1	1	1	1	1	1	1	1	1
1	1	1	1	1	1	1	1	1	1	1	1	1	1	1	1	1	1
1	1	1	1	1	1	1	1	1	1	1	1	1	1	1	1	1	1
288 14 11
300 6 9
301 7 9
301 8 9
301 9 9
301 7 8
301 8 8
10