13 16
9 9
2
0
1.0 1
1	1	1	1	1	1	1	1	1	1	1	1	1
1	1	1	1	1	1	1	1	1	1	1	1	1
1	1	1	1	1	1	1	1	1	1	1	1	1
1	1	1	16	16	16	16	16	16	16	1	1	1
1	1	1	16	17	17	17	17	17	16	1	1	1
1	1	1	16	17	17	17	17	17	16	1	1	1
1	1	1	16	17	17	17	17	17	17	1	1	1
1	1	1	16	14	14	14	14	14	17	1	1	1
1	1	1	16	14	14	14	14	14	17	1	1	1
1	1	1	16	14	14	14	14	14	14	0	1	1
1	1	1	16	14	14	14	14	14	16	1	1	1
1	1	1	16	14	14	14	14	14	16	1	1	1
1	1	1	16	16	16	16	16	16	16	1	1	1
1	1	1	1	1	1	1	1	1	1	1	1	1
1	1	1	1	1	1	1	1	1	1	1	1	1
1	1	1	1	1	1	1	1	1	1	1	1	1
351 4 9
292 10 9
26 10
6