27 33
12 7
53
0
0 0
1	1	1	1	1	1	1	1	1	1	1	1	1	1	1	1	1	1	1	1	1	1	1	1	1	1	1
1	1	1	1	1	1	1	1	1	1	1	1	1	1	1	1	1	1	1	1	1	1	1	1	1	1	1
1	1	1	1	1	1	1	1	1	1	1	1	1	1	1	1	1	1	1	1	1	1	1	1	1	1	1
1	1	1	1	16	16	16	16	16	16	16	16	16	16	16	16	16	16	16	16	16	16	16	1	1	1	1
1	1	1	1	16	17	17	17	17	17	17	17	17	17	17	17	17	17	17	17	17	17	16	1	1	1	1
1	1	1	1	16	17	17	17	17	17	17	17	17	17	17	17	17	17	17	17	17	17	16	1	1	1	1
1	1	1	1	16	17	17	17	17	17	17	17	17	17	17	17	17	17	17	17	17	17	16	1	1	1	1
1	1	1	1	16	14	14	14	14	14	14	14	14	14	14	14	14	14	14	14	14	14	16	1	1	1	1
1	1	1	1	16	14	14	14	14	14	14	14	14	14	14	14	14	14	14	14	14	14	16	1	1	1	1
1	1	1	1	16	14	14	14	14	14	14	14	14	14	14	14	14	14	14	14	14	14	16	1	1	1	1
1	1	1	1	16	14	14	14	14	14	14	14	14	14	14	14	14	14	14	14	14	14	16	1	1	1	1
1	1	1	1	16	14	14	14	14	14	14	14	14	14	14	14	14	14	14	14	14	14	16	1	1	1	1
1	1	1	1	16	14	14	14	14	14	14	14	14	14	14	14	14	14	14	14	14	14	16	1	1	1	1
1	1	1	1	17	14	14	14	14	14	14	17	17	17	17	17	14	14	14	14	14	14	17	1	1	1	1
1	1	1	1	17	14	14	14	14	14	14	17	17	17	17	17	14	14	14	14	14	14	17	1	1	1	1
1	1	1	1	17	14	14	14	14	14	14	17	17	17	17	17	14	14	14	14	14	14	17	1	1	1	1
1	1	1	0	14	14	14	14	14	14	14	17	17	17	17	17	14	14	14	14	14	14	14	0	1	1	1
1	1	1	1	16	14	14	14	14	14	14	1	1	1	1	1	14	14	14	14	14	14	16	1	1	1	1
1	1	1	1	16	14	14	14	14	14	14	1	1	1	1	1	14	14	14	14	14	14	16	1	1	1	1
1	1	1	1	16	14	14	14	14	14	14	1	1	1	1	1	14	14	14	14	14	14	16	1	1	1	1
1	1	1	1	16	14	14	14	14	14	14	1	1	1	1	1	14	14	14	14	14	14	16	1	1	1	1
1	1	1	1	16	14	14	14	14	14	14	1	1	0	1	1	14	14	14	14	14	14	16	1	1	1	1
1	1	1	1	16	14	14	14	14	14	14	14	14	14	14	14	14	14	14	14	14	14	16	1	1	1	1
1	1	1	1	16	14	14	14	14	14	14	14	14	14	14	14	14	14	14	14	14	14	16	1	1	1	1
1	1	1	1	16	14	14	14	14	14	14	14	14	14	14	14	14	14	14	14	14	14	16	1	1	1	1
1	1	1	1	16	14	14	14	14	14	14	14	14	14	14	14	14	14	14	14	14	14	16	1	1	1	1
1	1	1	1	16	14	14	14	14	14	14	14	14	14	14	14	14	14	14	14	14	14	16	1	1	1	1
1	1	1	1	16	14	14	14	14	14	14	14	14	14	14	14	14	14	14	14	14	14	16	1	1	1	1
1	1	1	1	16	16	16	16	16	16	16	16	16	14	16	16	16	16	16	16	16	16	16	1	1	1	1
1	1	1	1	1	1	1	1	1	1	1	1	1	0	1	1	1	1	1	1	1	1	1	1	1	1	1
1	1	1	1	1	1	1	1	1	1	1	1	1	1	1	1	1	1	1	1	1	1	1	1	1	1	1
1	1	1	1	1	1	1	1	1	1	1	1	1	1	1	1	1	1	1	1	1	1	1	1	1	1	1
1	1	1	1	1	1	1	1	1	1	1	1	1	1	1	1	1	1	1	1	1	1	1	1	1	1	1
293 13 29
294 23 16
295 13 6
296 3 16
284 13 21
126 6 9
101 7 9
126 6 12
101 7 12
126 6 15
101 7 15
127 6 19
101 7 19
127 6 22
101 7 22
127 6 25
101 7 25
126 9 9
101 10 9
126 9 12
101 10 12
126 9 15
101 10 15
127 9 19
101 10 19
127 9 22
101 10 22
127 9 25
101 10 25
126 16 9
101 17 9
126 16 12
101 17 12
126 16 15
101 17 15
127 16 19
101 17 19
127 16 22
101 17 22
127 16 25
101 17 25
126 19 9
101 20 9
126 19 12
101 20 12
126 19 15
101 20 15
127 19 19
101 20 19
127 19 22
101 20 22
127 19 25
101 20 25