27 54
12 7
29
0
0 0
1	1	1	1	1	1	1	1	1	1	1	1	1	1	1	1	1	1	1	1	1	1	1	1	1	1	1
1	1	1	1	1	1	1	1	1	1	1	1	1	1	1	1	1	1	1	1	1	1	1	1	1	1	1
1	1	1	1	1	1	1	1	1	1	1	1	1	1	1	1	1	1	1	1	1	1	1	1	1	1	1
1	1	1	1	16	16	16	16	16	16	16	16	16	16	16	16	16	16	16	16	16	16	16	1	1	1	1
1	1	1	1	16	17	17	17	17	17	17	17	17	17	17	17	17	17	17	17	17	17	16	1	1	1	1
1	1	1	1	16	17	17	17	17	17	17	17	17	17	17	17	17	17	17	17	17	17	16	1	1	1	1
1	1	1	1	16	17	17	17	17	17	17	17	17	17	17	17	17	17	17	17	17	17	16	1	1	1	1
1	1	1	1	16	14	14	14	14	14	14	14	14	14	14	14	14	14	14	14	14	14	16	1	1	1	1
1	1	1	1	16	14	14	14	14	14	14	14	14	14	14	14	14	14	14	14	14	14	16	1	1	1	1
1	1	1	1	16	14	14	14	14	14	14	14	14	14	14	14	14	14	14	14	14	14	16	1	1	1	1
1	1	1	1	16	14	14	14	14	14	14	14	14	14	14	14	14	14	14	14	14	14	16	1	1	1	1
1	1	1	1	16	14	14	14	14	14	14	14	14	14	14	14	14	14	14	14	14	14	16	1	1	1	1
1	1	1	1	16	14	14	14	14	14	14	14	14	14	14	14	14	14	14	14	14	14	16	1	1	1	1
1	1	1	1	17	14	14	14	14	14	14	17	17	17	17	17	14	14	14	14	14	14	17	1	1	1	1
1	1	1	1	17	14	14	14	14	14	14	17	17	17	17	17	14	14	14	14	14	14	17	1	1	1	1
1	1	1	1	17	14	14	14	14	14	14	17	17	17	17	17	14	14	14	14	14	14	17	1	1	1	1
1	1	1	0	14	14	14	14	14	14	14	1	1	1	1	1	14	14	14	14	14	14	14	0	1	1	1
1	1	1	1	16	14	14	14	14	14	14	1	1	1	1	1	14	14	14	14	14	14	16	1	1	1	1
1	1	1	1	16	14	14	14	14	14	14	1	1	1	1	1	14	14	14	14	14	14	16	1	1	1	1
1	1	1	1	16	14	14	14	14	14	14	1	1	1	1	1	14	14	14	14	14	14	16	1	1	1	1
1	1	1	1	16	14	14	14	14	14	14	1	1	1	1	1	14	14	14	14	14	14	16	1	1	1	1
1	1	1	1	16	14	14	14	14	14	14	1	1	1	1	1	14	14	14	14	14	14	16	1	1	1	1
1	1	1	1	16	14	14	14	14	14	14	14	14	14	14	14	14	14	14	14	14	14	16	1	1	1	1
1	1	1	1	16	14	14	14	14	14	14	14	14	14	14	14	14	14	14	14	14	14	16	1	1	1	1
1	1	1	1	16	14	14	14	14	14	14	14	14	14	14	14	14	14	14	14	14	14	16	1	1	1	1
1	1	1	1	16	14	14	14	14	14	14	14	14	14	14	14	14	14	14	14	14	14	16	1	1	1	1
1	1	1	1	16	14	14	14	14	14	14	14	14	14	14	14	14	14	14	14	14	14	16	1	1	1	1
1	1	1	1	16	14	14	14	14	14	14	14	14	14	14	14	14	14	14	14	14	14	16	1	1	1	1
1	1	1	1	16	16	16	16	16	16	16	14	14	14	14	14	16	16	16	16	16	16	16	1	1	1	1
1	1	1	1	1	1	1	1	1	1	16	14	14	14	14	14	16	1	1	1	1	1	1	1	1	1	1
1	1	1	1	1	1	1	1	1	1	17	14	14	14	14	14	17	1	1	1	1	1	1	1	1	1	1
1	1	1	1	1	1	1	1	1	1	17	14	14	14	14	14	17	1	1	1	1	1	1	1	1	1	1
1	1	1	1	1	1	1	1	1	1	17	14	14	14	14	14	17	1	1	1	1	1	1	1	1	1	1
1	1	1	1	1	1	1	1	1	0	14	14	14	14	14	14	14	0	1	1	1	1	1	1	1	1	1
1	1	1	1	1	1	1	1	1	1	16	14	14	14	14	14	16	1	1	1	1	1	1	1	1	1	1
1	1	1	1	1	1	1	1	1	1	16	14	14	14	14	14	16	1	1	1	1	1	1	1	1	1	1
1	1	1	1	1	1	1	1	1	1	16	14	14	14	14	14	16	1	1	1	1	1	1	1	1	1	1
1	1	1	1	1	1	1	1	1	1	17	14	14	14	14	14	17	1	1	1	1	1	1	1	1	1	1
1	1	1	1	1	1	1	1	1	1	17	14	14	14	14	14	17	1	1	1	1	1	1	1	1	1	1
1	1	1	1	1	1	1	1	1	1	17	14	14	14	14	14	17	1	1	1	1	1	1	1	1	1	1
1	1	1	1	1	1	1	1	1	0	14	14	14	14	14	14	14	0	1	1	1	1	1	1	1	1	1
1	1	1	1	1	1	1	1	1	1	16	14	14	14	14	14	16	1	1	1	1	1	1	1	1	1	1
1	1	1	1	1	1	1	1	1	1	16	14	14	14	14	14	16	1	1	1	1	1	1	1	1	1	1
1	1	1	1	1	1	1	1	1	1	16	14	14	14	14	14	16	16	16	16	16	1	1	1	1	1	1
1	1	1	1	1	1	1	1	1	1	17	14	14	14	14	14	17	17	17	17	16	1	1	1	1	1	1
1	1	1	1	1	1	1	1	1	1	17	14	14	14	14	14	17	17	17	17	17	1	1	1	1	1	1
1	1	1	1	1	1	1	1	1	1	17	14	14	14	14	14	17	17	17	17	17	1	1	1	1	1	1
1	1	1	1	1	1	1	1	1	0	14	14	14	14	14	14	14	14	14	14	17	1	1	1	1	1	1
1	1	1	1	1	1	1	1	1	1	16	14	14	14	14	14	14	14	14	14	14	0	1	1	1	1	1
1	1	1	1	1	1	1	1	1	1	16	14	14	14	14	14	14	14	14	14	16	1	1	1	1	1	1
1	1	1	1	1	1	1	1	1	1	16	16	16	14	16	16	16	16	16	16	16	1	1	1	1	1	1
1	1	1	1	1	1	1	1	1	1	1	1	1	0	1	1	1	1	1	1	1	1	1	1	1	1	1
1	1	1	1	1	1	1	1	1	1	1	1	1	1	1	1	1	1	1	1	1	1	1	1	1	1	1
1	1	1	1	1	1	1	1	1	1	1	1	1	1	1	1	1	1	1	1	1	1	1	1	1	1	1
274 13 51
285 3 16
286 9 47
287 21 48
297 23 16
343 7 9
126 7 10
101 8 10
344 7 13
126 7 14
101 8 14
345 7 19
127 7 18
101 8 18
346 7 23
127 7 22
101 8 22
347 18 9
126 18 10
101 19 10
348 18 13
126 18 14
101 19 14
349 18 19
127 18 18
101 19 18
350 18 23
127 18 22
101 19 22