27 54
12 7
5
0
0 0
1	1	1	1	1	1	1	1	1	1	1	1	1	1	1	1	1	1	1	1	1	1	1	1	1	1	1
1	1	1	1	1	1	1	1	1	1	1	1	1	1	1	1	1	1	1	1	1	1	1	1	1	1	1
1	1	1	1	1	1	1	1	1	1	1	1	1	1	1	1	1	1	1	1	1	1	1	1	1	1	1
1	1	1	1	16	16	16	16	16	16	16	16	16	16	16	16	16	16	16	16	16	16	16	1	1	1	1
1	1	1	1	16	17	17	17	17	17	17	17	17	17	17	17	17	17	17	17	17	17	16	1	1	1	1
1	1	1	1	16	17	17	17	17	17	17	17	17	17	17	17	17	17	17	17	17	17	16	1	1	1	1
1	1	1	1	16	17	17	17	17	17	17	17	17	17	17	17	17	17	17	17	17	17	16	1	1	1	1
1	1	1	1	16	14	14	14	14	14	14	14	14	14	14	14	14	14	14	14	14	14	16	1	1	1	1
1	1	1	1	16	14	14	14	14	14	14	14	14	14	14	14	14	14	14	14	14	14	16	1	1	1	1
1	1	1	1	16	14	14	14	14	14	14	14	14	14	14	14	14	14	14	14	14	14	16	1	1	1	1
1	1	1	1	16	14	14	14	14	14	14	14	14	14	14	14	14	14	14	14	14	14	16	1	1	1	1
1	1	1	1	16	14	14	14	14	14	14	14	14	14	14	14	14	14	14	14	14	14	16	1	1	1	1
1	1	1	1	16	14	14	14	14	14	14	14	14	14	14	14	14	14	14	14	14	14	16	1	1	1	1
1	1	1	1	17	14	14	14	14	14	14	17	17	17	17	17	14	14	14	14	14	14	17	1	1	1	1
1	1	1	1	17	14	14	14	14	14	14	17	17	17	17	17	14	14	14	14	14	14	17	1	1	1	1
1	1	1	1	17	14	14	14	14	14	14	17	17	17	17	17	14	14	14	14	14	14	17	1	1	1	1
1	1	1	0	14	14	14	14	14	14	14	1	1	1	1	1	14	14	14	14	14	14	14	0	1	1	1
1	1	1	1	16	14	14	14	14	14	14	1	1	1	1	1	14	14	14	14	14	14	16	1	1	1	1
1	1	1	1	16	14	14	14	14	14	14	1	1	1	1	1	14	14	14	14	14	14	16	1	1	1	1
1	1	1	1	16	14	14	14	14	14	14	1	1	1	1	1	14	14	14	14	14	14	16	1	1	1	1
1	1	1	1	16	14	14	14	14	14	14	1	1	1	1	1	14	14	14	14	14	14	16	1	1	1	1
1	1	1	1	16	14	14	14	14	14	14	1	1	1	1	1	14	14	14	14	14	14	16	1	1	1	1
1	1	1	1	16	14	14	14	14	14	14	14	14	14	14	14	14	14	14	14	14	14	16	1	1	1	1
1	1	1	1	16	14	14	14	14	14	14	14	14	14	14	14	14	14	14	14	14	14	16	1	1	1	1
1	1	1	1	16	14	14	14	14	14	14	14	14	14	14	14	14	14	14	14	14	14	16	1	1	1	1
1	1	1	1	16	14	14	14	14	14	14	14	14	14	14	14	14	14	14	14	14	14	16	1	1	1	1
1	1	1	1	16	14	14	14	14	14	14	14	14	14	14	14	14	14	14	14	14	14	16	1	1	1	1
1	1	1	1	16	14	14	14	14	14	14	14	14	14	14	14	14	14	14	14	14	14	16	1	1	1	1
1	1	1	1	16	16	16	16	16	16	16	16	16	14	16	16	16	16	16	16	16	16	16	1	1	1	1
1	1	1	1	1	1	1	1	1	1	16	17	17	14	17	17	16	1	1	1	1	1	1	1	1	1	1
1	1	1	1	1	1	1	1	1	1	17	17	17	14	17	17	17	1	1	1	1	1	1	1	1	1	1
1	1	1	1	1	1	1	1	1	1	17	17	17	14	17	17	17	1	1	1	1	1	1	1	1	1	1
1	1	1	1	1	1	1	1	1	1	17	14	14	14	14	14	17	1	1	1	1	1	1	1	1	1	1
1	1	1	1	1	1	1	1	1	0	14	14	14	14	14	14	14	0	1	1	1	1	1	1	1	1	1
1	1	1	1	1	1	1	1	1	1	16	14	14	14	14	14	16	1	1	1	1	1	1	1	1	1	1
1	1	1	1	1	1	1	1	1	1	16	14	14	14	14	14	16	1	1	1	1	1	1	1	1	1	1
1	1	1	1	1	1	1	1	1	1	16	14	14	14	14	14	16	1	1	1	1	1	1	1	1	1	1
1	1	1	1	1	1	1	1	1	1	17	14	14	14	14	14	17	1	1	1	1	1	1	1	1	1	1
1	1	1	1	1	1	1	1	1	1	17	14	14	14	14	14	17	1	1	1	1	1	1	1	1	1	1
1	1	1	1	1	1	1	1	1	1	17	14	14	14	14	14	17	1	1	1	1	1	1	1	1	1	1
1	1	1	1	1	1	1	1	1	0	14	14	14	14	14	14	14	0	1	1	1	1	1	1	1	1	1
1	1	1	1	1	1	1	1	1	1	16	14	14	14	14	14	16	1	1	1	1	1	1	1	1	1	1
1	1	1	1	1	1	1	1	1	1	16	14	14	14	14	14	16	1	1	1	1	1	1	1	1	1	1
1	1	1	1	1	1	1	1	1	1	16	14	14	14	14	14	16	16	16	16	16	1	1	1	1	1	1
1	1	1	1	1	1	1	1	1	1	17	14	14	14	14	14	17	17	17	17	16	1	1	1	1	1	1
1	1	1	1	1	1	1	1	1	1	17	14	14	14	14	14	17	17	17	17	17	1	1	1	1	1	1
1	1	1	1	1	1	1	1	1	1	17	14	14	14	14	14	17	17	17	17	17	1	1	1	1	1	1
1	1	1	1	1	1	1	1	1	0	14	14	14	14	14	14	14	14	14	14	17	1	1	1	1	1	1
1	1	1	1	1	1	1	1	1	1	16	14	14	14	14	14	14	14	14	14	14	0	1	1	1	1	1
1	1	1	1	1	1	1	1	1	1	16	14	14	14	14	14	14	14	14	14	16	1	1	1	1	1	1
1	1	1	1	1	1	1	1	1	1	16	16	16	14	16	16	16	16	16	16	16	1	1	1	1	1	1
1	1	1	1	1	1	1	1	1	1	1	1	1	0	1	1	1	1	1	1	1	1	1	1	1	1	1
1	1	1	1	1	1	1	1	1	1	1	1	1	1	1	1	1	1	1	1	1	1	1	1	1	1	1
1	1	1	1	1	1	1	1	1	1	1	1	1	1	1	1	1	1	1	1	1	1	1	1	1	1	1
274 13 51
285 3 16
286 9 47
287 21 48
297 23 16
