31 22
26 7
10
0
0 0
1	1	1	1	1	1	1	1	1	1	1	1	1	1	1	1	1	1	1	1	1	1	1	1	1	1	1	1	1	1	1
1	1	1	1	1	1	1	1	1	1	1	1	1	1	1	1	1	1	1	1	1	1	1	1	1	1	1	1	1	1	1
1	1	1	1	1	1	1	1	1	1	1	1	1	1	1	1	1	1	1	1	1	1	1	1	1	1	1	1	1	1	1
1	1	1	1	1	1	1	1	1	1	1	16	16	16	16	16	16	16	16	16	16	16	16	16	16	16	16	1	1	1	1
1	1	1	1	1	1	1	1	1	1	1	16	17	17	17	17	17	17	17	17	17	17	17	17	17	17	17	1	1	1	1
1	1	1	1	1	1	1	1	1	1	1	16	17	17	17	17	17	17	17	17	17	17	17	17	17	17	17	1	1	1	1
1	1	1	1	1	1	1	1	1	1	1	16	17	17	17	17	17	17	17	17	17	17	17	17	17	17	17	1	1	1	1
1	1	1	1	1	1	1	1	1	1	1	16	14	14	14	14	14	14	14	14	14	14	14	14	14	14	14	0	1	1	1
1	1	1	1	1	1	1	1	1	1	1	16	14	14	14	14	14	14	14	14	14	14	14	14	14	14	16	1	1	1	1
1	1	1	16	16	16	0	0	0	16	16	16	14	14	14	14	14	14	14	14	14	14	14	14	14	14	16	1	1	1	1
1	1	1	16	17	17	18	18	18	17	17	17	14	14	14	14	14	14	14	14	14	14	14	14	14	14	16	1	1	1	1
1	1	1	16	17	17	18	18	18	17	17	17	14	14	14	14	14	14	14	14	14	14	14	14	14	14	16	1	1	1	1
1	1	1	16	17	17	18	18	18	17	17	17	14	14	14	14	14	14	14	14	14	16	16	16	16	16	16	1	1	1	1
1	1	1	16	14	14	14	14	14	14	14	14	14	14	14	14	14	14	14	14	14	16	1	1	1	1	1	1	1	1	1
1	1	1	16	14	14	14	14	14	14	14	14	14	14	14	14	14	14	14	14	14	16	1	1	1	1	1	1	1	1	1
1	1	1	16	14	14	14	14	14	14	14	14	14	14	14	14	14	14	14	14	14	16	1	1	1	1	1	1	1	1	1
1	1	1	16	14	14	14	14	14	14	14	14	14	14	14	14	14	14	14	14	14	16	1	1	1	1	1	1	1	1	1
1	1	1	16	14	14	14	14	14	14	14	14	14	14	14	14	14	14	14	14	14	16	1	1	1	1	1	1	1	1	1
1	1	1	16	16	16	16	16	16	16	16	16	16	16	16	16	16	16	16	16	16	16	1	1	1	1	1	1	1	1	1
1	1	1	1	1	1	1	1	1	1	1	1	1	1	1	1	1	1	1	1	1	1	1	1	1	1	1	1	1	1	1
1	1	1	1	1	1	1	1	1	1	1	1	1	1	1	1	1	1	1	1	1	1	1	1	1	1	1	1	1	1	1
1	1	1	1	1	1	1	1	1	1	1	1	1	1	1	1	1	1	1	1	1	1	1	1	1	1	1	1	1	1	1
270 27 7
271 6 9
271 7 9
271 8 9
126 12 9
101 13 9
127 19 15
101 20 15
322 12 8
323 19 16
3