13 17
6 12
2
3
0 0
1	1	1	1	1	1	1	1	1	1	1	1	1
1	1	1	1	1	1	1	1	1	1	1	1	1
1	1	1	30	30	30	30	30	30	30	1	1	1
1	1	1	30	31	31	31	31	31	30	1	1	1
1	1	1	31	31	31	31	31	31	30	1	1	1
1	1	1	31	31	31	31	31	31	30	1	1	1
1	1	1	31	40	40	40	40	40	30	1	1	1
1	1	1	40	40	40	40	40	40	30	1	1	1
1	0	20	40	40	40	40	40	40	30	1	1	1
1	0	1	30	40	40	40	40	40	30	1	1	1
1	1	1	30	40	40	40	40	40	30	1	1	1
1	1	1	30	40	40	40	40	40	30	1	1	1
1	1	1	30	30	30	40	30	30	30	1	1	1
1	1	1	1	1	1	0	1	1	1	1	1	1
1	1	1	1	1	1	1	1	1	1	1	1	1
1	1	1	1	1	1	1	1	1	1	1	1	1
1	1	1	1	1	1	1	1	1	1	1	1	1
581 6 13
582 1 8
32 64 224
33 64 256
93 64 288
18