18 17
5 13
3
6
0 0
1	1	1	1	1	1	1	1	1	1	1	1	1	1	1	1	1	1
1	1	1	1	1	1	1	1	1	1	1	1	1	1	1	1	1	1
1	1	1	1	1	1	1	1	1	1	1	1	1	1	1	1	1	1
1	1	1	30	30	30	30	30	30	30	30	30	30	30	20	1	1	1
1	1	1	30	31	31	31	31	31	31	31	31	31	31	1	1	1	1
1	1	1	30	31	31	31	31	31	31	31	31	31	31	1	1	0	1
1	1	1	30	31	31	31	31	31	31	31	31	31	31	1	20	0	1
1	1	1	30	40	40	40	40	40	40	40	40	40	40	20	1	1	1
1	1	1	30	40	40	40	40	40	40	40	40	40	40	1	1	1	1
1	1	1	30	40	40	40	40	40	40	40	40	40	30	1	1	1	1
1	1	1	30	40	40	40	40	40	40	40	40	40	30	1	1	1	1
1	1	1	30	40	40	40	40	40	40	40	40	40	30	1	1	1	1
1	1	1	30	30	19	30	30	30	30	30	30	40	30	1	1	1	1
1	1	1	1	1	19	1	1	1	1	1	1	0	1	1	1	1	1
1	1	1	1	1	0	1	1	1	1	1	1	1	1	1	1	1	1
1	1	1	1	1	1	1	1	1	1	1	1	1	1	1	1	1	1
1	1	1	1	1	1	1	1	1	1	1	1	1	1	1	1	1	1
559 5 14
560 12 13
561 16 6
32 448 192
32 480 160
33 448 224
33 480 192
93 448 256
93 480 224
12