28 32
6 7
3
0
0 0
1	1	1	1	1	1	1	1	1	1	1	1	1	1	1	1	1	1	1	1	1	1	1	1	1	1	1	1
1	1	1	1	1	1	1	1	1	1	1	1	1	1	1	1	1	1	1	1	1	1	1	1	1	1	1	1
1	1	1	1	1	1	1	1	1	1	1	1	1	1	1	1	1	1	1	1	1	1	1	1	1	1	1	1
1	1	1	30	30	30	30	30	30	30	30	30	30	30	30	30	30	30	30	30	30	30	30	30	30	1	1	1
1	1	1	30	31	31	31	31	31	31	31	31	31	31	31	31	31	31	31	31	31	31	31	31	30	1	1	1
1	1	1	30	31	31	31	31	31	31	31	31	31	31	31	31	31	31	31	31	31	31	31	31	30	1	1	1
1	1	1	30	31	31	31	31	31	31	31	31	31	31	31	31	31	31	31	31	31	31	31	31	30	1	1	1
1	1	1	30	40	40	40	40	40	40	40	40	40	40	40	40	40	40	40	40	40	40	40	40	30	1	1	1
1	1	1	30	40	40	40	40	40	40	40	40	40	40	40	40	40	40	40	40	40	40	40	40	30	1	1	1
1	1	1	30	40	40	40	40	40	40	40	40	40	40	40	40	40	40	40	40	40	40	40	40	30	1	1	1
1	1	1	30	40	40	40	40	40	40	40	40	40	40	40	40	40	40	40	40	40	40	40	40	30	1	1	1
1	1	1	30	40	40	40	40	40	40	40	40	40	40	40	40	40	40	40	40	40	40	40	40	30	1	1	1
1	1	1	30	40	40	40	40	40	30	30	30	30	30	30	30	30	30	30	40	40	40	40	40	30	1	1	1
1	1	1	30	40	40	40	40	40	30	30	30	30	30	30	30	30	30	30	40	40	40	40	40	30	1	1	1
1	1	1	30	40	40	40	40	40	30	30	30	30	30	30	30	30	30	30	40	40	40	40	40	30	1	1	1
1	1	1	30	40	40	40	40	40	30	30	30	30	30	30	30	30	30	30	40	40	40	40	40	30	1	1	1
1	1	1	30	40	40	40	40	40	30	30	30	30	30	30	30	30	30	30	40	40	40	40	40	30	1	1	1
1	1	1	30	40	40	40	40	40	30	30	30	30	30	30	30	30	30	30	40	40	40	40	40	30	1	1	1
1	1	1	30	40	40	40	40	40	30	30	30	30	30	30	30	30	30	30	40	40	40	40	40	30	1	1	1
1	1	1	30	40	40	40	40	40	30	30	30	30	30	30	30	30	30	30	40	40	40	40	40	30	1	1	1
1	1	1	31	40	40	40	40	40	31	31	31	31	31	31	31	31	31	31	40	40	40	40	40	30	1	1	1
1	1	1	31	40	40	40	40	40	31	31	31	31	31	31	31	31	31	31	40	40	40	40	40	30	1	1	1
1	1	1	31	40	40	40	40	40	31	31	31	31	31	31	31	31	31	31	40	40	40	40	40	30	1	1	1
1	1	0	40	40	40	40	40	40	40	40	40	40	40	40	40	40	40	40	40	40	40	40	40	30	1	1	1
1	1	1	30	40	40	40	40	40	40	40	40	40	40	40	40	40	40	40	40	40	40	40	40	30	1	1	1
1	1	1	30	40	40	40	40	40	40	40	40	40	40	40	40	40	40	40	40	40	40	40	40	30	1	1	1
1	1	1	30	40	40	40	40	40	40	40	40	40	40	40	40	40	40	40	40	40	40	40	40	30	1	1	1
1	1	1	30	40	40	40	40	40	40	40	40	40	40	40	40	40	40	40	40	40	40	40	40	30	1	1	1
1	1	1	30	30	30	30	30	30	30	30	30	30	30	30	30	30	30	30	30	30	30	30	30	30	1	1	1
1	1	1	1	1	1	1	1	1	1	1	1	1	1	1	1	1	1	1	1	1	1	1	1	1	1	1	1
1	1	1	1	1	1	1	1	1	1	1	1	1	1	1	1	1	1	1	1	1	1	1	1	1	1	1	1
1	1	1	1	1	1	1	1	1	1	1	1	1	1	1	1	1	1	1	1	1	1	1	1	1	1	1	1
572 6 6
573 2 23
574 21 6
17