36 23
4 16
2
0
0 0
1	1	1	1	1	1	1	1	1	1	1	1	1	1	1	1	1	1	1	1	1	1	1	1	1	1	1	1	1	1	1	1	1	1	1	1
1	1	1	1	1	1	1	1	1	1	1	1	1	1	1	1	1	1	1	1	1	1	1	1	1	1	1	1	1	1	1	1	1	1	1	1
1	1	1	1	1	1	1	1	1	1	1	1	1	1	1	1	1	1	1	1	1	1	1	1	1	1	1	1	1	1	1	1	1	1	1	1
1	1	1	1	1	1	1	1	30	30	30	30	30	30	30	30	30	30	30	30	30	30	30	30	30	30	30	30	1	1	1	1	1	1	1	1
1	1	1	1	1	1	1	1	30	31	31	31	31	31	31	31	31	31	31	31	31	31	31	31	31	31	31	30	1	1	1	1	1	1	1	1
1	1	1	1	1	1	1	1	30	31	31	31	31	31	31	31	31	31	31	31	31	31	31	31	31	31	31	30	1	1	1	1	1	1	1	1
1	1	1	1	1	1	1	1	30	31	31	31	31	31	31	31	31	31	31	31	31	31	31	31	31	31	31	30	1	1	1	1	1	1	1	1
1	1	1	1	1	1	1	1	30	40	40	40	40	40	40	40	40	40	40	40	40	40	40	40	40	40	40	30	1	1	1	1	1	1	1	1
1	1	1	1	1	1	1	1	30	40	40	40	40	40	40	40	40	40	40	40	40	40	40	40	40	40	40	30	1	1	1	1	1	1	1	1
1	1	1	1	1	1	1	1	30	40	40	40	40	40	40	40	40	40	40	40	40	40	40	40	40	40	40	30	1	1	1	1	1	1	1	1
1	1	1	1	30	30	30	30	30	40	40	40	40	40	40	40	40	40	40	40	40	40	40	40	40	40	40	30	30	30	30	30	1	1	1	1
1	1	1	1	30	31	31	31	31	40	40	40	40	40	40	40	40	40	40	40	40	40	40	40	40	40	40	31	31	31	31	30	1	1	1	1
1	1	1	1	30	31	31	31	31	40	40	40	30	30	30	40	40	40	40	40	40	30	30	30	40	40	40	31	31	31	31	30	1	1	1	1
1	1	1	1	31	31	31	31	31	40	40	40	30	1	30	40	40	40	40	40	40	30	1	30	40	40	40	31	31	31	31	30	1	1	1	1
1	1	1	1	31	40	40	40	40	40	40	40	30	1	30	40	40	40	40	40	40	30	1	30	40	40	40	40	40	40	40	30	1	1	1	1
1	1	1	1	31	40	40	40	40	40	40	40	30	1	30	40	40	40	40	40	40	30	1	30	40	40	40	40	40	40	40	30	1	1	1	1
1	1	1	0	40	40	40	40	40	40	40	40	30	1	30	40	40	40	40	40	40	30	1	30	40	40	40	40	40	40	40	30	1	1	1	1
1	1	1	1	30	40	40	40	40	40	40	40	30	1	30	40	40	40	40	40	40	30	1	30	40	40	40	40	40	40	40	30	1	1	1	1
1	1	1	1	30	40	40	40	40	40	40	40	30	1	30	30	30	30	30	30	30	30	1	30	40	40	40	40	40	40	40	30	1	1	1	1
1	1	1	1	30	30	30	30	30	30	30	30	30	1	1	1	1	1	1	1	1	1	1	30	30	30	30	30	40	30	30	30	1	1	1	1
1	1	1	1	1	1	1	1	1	1	1	1	1	1	1	1	1	1	1	1	1	1	1	1	1	1	1	1	0	1	1	1	1	1	1	1
1	1	1	1	1	1	1	1	1	1	1	1	1	1	1	1	1	1	1	1	1	1	1	1	1	1	1	1	1	1	1	1	1	1	1	1
1	1	1	1	1	1	1	1	1	1	1	1	1	1	1	1	1	1	1	1	1	1	1	1	1	1	1	1	1	1	1	1	1	1	1	1
578 3 16
579 28 20
17