23 26
3 19
8
0
0 0
1	1	1	1	1	1	1	1	1	1	1	1	1	1	1	1	1	1	1	1	1	1	1
1	1	1	1	1	1	1	1	1	1	1	1	1	1	1	1	1	1	1	1	1	1	1
1	1	1	1	1	1	1	1	1	1	1	1	1	1	1	1	1	1	1	1	1	1	1
1	1	1	30	30	30	30	30	30	30	30	30	30	30	30	30	30	30	30	30	1	1	1
1	1	1	30	31	31	31	31	31	31	31	31	31	31	31	31	31	31	31	30	1	1	1
1	1	1	30	31	31	31	31	31	31	31	31	31	31	31	31	31	31	31	30	1	1	1
1	1	1	30	31	31	31	31	31	31	31	31	31	31	31	31	31	31	31	31	1	1	1
1	1	1	30	40	40	40	40	40	40	40	40	40	40	40	40	40	40	40	31	1	1	1
1	1	1	30	40	40	40	40	40	40	40	40	40	40	40	40	40	40	40	31	1	1	1
1	1	1	30	40	40	40	40	40	40	40	40	40	40	40	40	40	40	40	40	0	1	1
1	1	1	30	40	40	40	40	40	40	40	40	40	40	40	40	40	40	40	30	1	1	1
1	1	1	30	40	40	40	40	40	40	40	40	40	40	40	40	40	40	40	30	1	1	1
1	1	1	30	40	40	40	40	40	30	30	30	30	30	40	40	40	40	40	30	1	1	1
1	1	1	30	40	40	40	40	40	30	30	30	30	30	40	40	40	40	40	30	1	1	1
1	1	1	30	40	40	40	40	40	31	31	31	31	31	40	40	40	40	40	30	1	1	1
1	1	1	30	40	40	40	40	40	31	31	31	31	31	40	40	40	40	40	30	1	1	1
1	1	1	31	40	40	40	40	40	31	31	31	31	31	40	40	40	40	40	31	1	1	1
1	1	1	31	40	40	40	40	40	40	40	40	40	40	40	40	40	40	40	31	1	1	1
1	1	1	31	40	40	40	40	40	40	40	40	40	40	40	40	40	40	40	31	1	1	1
1	1	0	40	40	40	40	40	40	40	40	40	40	40	40	40	40	40	40	40	0	1	1
1	1	1	30	40	40	40	40	40	40	40	40	40	40	40	40	40	40	40	30	1	1	1
1	1	1	30	40	40	40	40	40	40	40	40	40	40	40	40	40	40	40	30	1	1	1
1	1	1	30	30	30	40	30	30	30	30	30	30	30	30	30	40	30	30	30	1	1	1
1	1	1	1	1	1	0	1	1	1	1	1	1	1	1	1	0	1	1	1	1	1	1
1	1	1	1	1	1	1	1	1	1	1	1	1	1	1	1	1	1	1	1	1	1	1
1	1	1	1	1	1	1	1	1	1	1	1	1	1	1	1	1	1	1	1	1	1	1
562 2 19
563 6 23
564 16 23
565 20 19
566 20 9
567 6 6
568 11 6
569 11 16
16