41 39
37 33
11
20
0 0
1	1	1	1	1	1	1	1	1	1	1	1	1	1	1	1	1	1	1	1	1	1	1	1	1	1	1	1	1	1	1	1	1	1	1	1	1	1	1	1	1
1	1	1	1	1	1	1	1	1	1	1	1	1	1	1	1	1	1	1	1	1	1	1	1	1	1	1	1	1	1	1	1	1	1	1	1	1	1	1	1	1
1	1	1	1	1	1	1	1	1	1	1	1	1	1	1	1	1	1	1	1	1	1	1	1	1	1	1	1	1	1	1	1	1	1	1	1	1	1	1	1	1
1	1	1	1	1	1	1	1	1	1	1	30	30	30	30	30	30	30	30	30	30	30	30	30	30	30	30	30	30	30	1	1	1	1	1	1	1	1	1	1	1
1	1	1	1	1	1	1	1	1	1	1	30	31	31	31	31	31	30	31	31	31	31	31	30	31	31	31	31	31	30	1	1	1	1	1	1	1	1	1	1	1
1	1	1	1	1	1	1	1	1	1	1	30	31	31	31	31	31	30	31	31	31	31	31	30	31	31	31	31	31	30	1	1	1	1	1	1	1	1	1	1	1
1	1	1	1	1	1	1	1	1	1	1	30	31	31	31	31	31	30	31	31	31	31	31	30	31	31	31	31	31	30	1	1	1	1	1	1	1	1	1	1	1
1	1	1	1	1	1	1	1	1	1	1	30	39	39	39	39	39	30	39	39	39	39	39	30	39	39	39	39	39	30	1	1	1	1	1	1	1	1	1	1	1
1	1	1	1	1	1	1	1	1	1	1	30	39	39	39	39	39	31	39	39	39	39	39	31	39	39	39	39	39	30	1	1	1	1	1	1	1	1	1	1	1
1	1	1	1	1	1	1	1	1	1	1	30	39	39	39	39	39	31	39	39	39	39	39	31	39	39	39	39	39	30	1	1	1	1	1	1	1	1	1	1	1
1	1	1	1	1	1	1	1	1	1	1	30	30	30	30	30	30	31	30	30	30	30	30	31	30	30	0	30	30	30	1	1	1	1	1	1	1	1	1	1	1
1	1	1	1	1	1	1	1	1	1	1	30	39	39	39	39	39	39	39	39	39	39	39	39	39	39	39	39	39	30	1	1	1	1	1	1	1	1	1	1	1
1	1	1	1	1	1	1	1	1	1	1	30	39	39	39	39	39	39	39	39	39	39	39	39	39	39	39	39	39	30	1	1	1	1	1	1	1	1	1	1	1
1	1	1	1	1	1	1	1	1	1	1	30	39	39	39	39	39	39	39	39	39	39	39	39	39	39	39	39	39	30	1	1	1	1	1	1	1	1	1	1	1
1	1	1	1	1	1	1	1	1	1	1	30	39	39	39	39	39	39	39	39	39	39	39	39	39	39	39	39	39	30	1	1	1	1	1	1	1	1	1	1	1
1	1	1	1	1	1	1	1	1	1	1	30	39	39	39	39	39	39	39	39	39	39	39	39	39	39	39	39	39	30	1	1	1	1	1	1	1	1	1	1	1
1	1	1	30	30	30	30	30	30	30	30	30	39	39	39	39	39	39	39	39	39	39	39	39	39	39	39	39	39	30	30	30	30	30	30	30	30	30	1	1	1
1	1	1	30	31	31	31	31	31	30	31	31	39	39	39	39	39	39	39	39	39	39	39	39	39	39	39	39	39	31	31	30	31	31	31	31	31	30	1	1	1
1	1	1	30	31	31	31	31	31	30	31	31	39	39	39	39	39	39	39	39	39	39	39	39	39	39	39	39	39	31	31	30	31	31	31	31	31	30	1	1	1
1	1	1	30	31	31	31	31	31	30	31	31	39	39	39	39	39	39	39	39	39	39	39	39	39	39	39	39	39	31	31	30	31	31	31	31	31	30	1	1	1
1	1	1	30	39	39	39	39	39	30	39	39	39	39	39	39	39	39	39	39	39	39	39	39	39	39	39	39	39	39	39	30	39	39	39	39	39	30	1	1	1
1	1	1	30	39	39	39	39	39	31	39	39	39	39	39	39	39	39	39	39	39	39	39	39	39	39	39	39	39	39	39	31	39	39	39	39	39	30	1	1	1
1	1	1	30	39	39	39	39	39	31	39	39	39	39	39	39	39	39	39	39	39	39	39	39	39	39	39	39	39	39	39	31	39	39	39	39	39	30	1	1	1
1	1	1	30	1	1	1	1	1	31	39	39	39	39	39	39	39	39	39	39	39	39	39	39	39	39	39	39	39	39	39	31	30	30	0	30	30	30	1	1	1
1	1	1	30	39	39	39	39	39	39	39	39	39	39	39	39	39	39	39	39	39	39	39	39	39	39	39	39	39	39	39	39	39	39	39	39	39	30	1	1	1
1	1	1	30	39	39	39	39	39	39	39	39	39	39	39	39	39	39	39	39	39	39	39	39	39	39	39	39	39	39	39	39	39	39	39	39	39	30	1	1	1
1	1	1	30	39	39	39	39	39	39	39	39	39	39	39	39	39	39	39	39	39	39	39	39	39	39	39	39	39	39	39	39	39	39	39	39	39	30	1	1	1
1	1	1	30	39	39	39	39	39	39	39	39	39	39	39	39	39	39	39	39	39	39	39	39	39	39	39	39	39	39	39	39	39	39	39	39	39	30	1	1	1
1	1	1	30	39	39	39	39	39	39	39	39	39	39	39	39	39	39	39	39	39	39	39	39	39	39	39	39	39	39	39	30	30	30	30	30	30	30	1	1	1
1	1	1	30	30	30	30	30	30	39	39	39	39	39	39	39	39	39	39	39	39	39	39	39	39	39	39	39	39	39	39	31	31	31	31	31	31	31	1	1	1
1	1	1	1	1	1	1	1	30	39	39	39	39	39	39	39	39	39	39	39	39	39	39	39	39	39	39	39	39	39	39	31	31	31	31	31	31	31	1	1	1
1	1	1	1	1	1	1	1	30	39	39	39	39	39	39	39	39	39	39	39	39	39	39	39	39	39	39	39	39	39	39	31	31	31	31	31	31	31	1	1	1
1	1	1	1	1	1	1	1	30	39	39	39	39	39	39	39	39	39	39	39	39	39	39	39	39	39	39	39	39	39	39	39	39	39	39	39	39	39	0	1	1
1	1	1	1	1	1	1	1	30	39	39	39	39	39	39	39	39	39	39	39	39	39	39	39	39	39	39	39	39	39	39	39	39	39	39	39	39	39	0	1	1
1	1	1	1	1	1	1	1	30	39	39	39	39	39	39	39	39	39	39	39	39	39	39	39	39	39	39	39	39	39	39	39	39	39	39	39	39	39	0	1	1
1	1	1	1	1	1	1	1	30	30	30	30	30	30	30	30	30	30	30	30	30	30	30	30	30	30	30	30	30	30	30	30	30	30	30	30	30	30	1	1	1
1	1	1	1	1	1	1	1	1	1	1	1	1	1	1	1	1	1	1	1	1	1	1	1	1	1	1	1	1	1	1	1	1	1	1	1	1	1	1	1	1
1	1	1	1	1	1	1	1	1	1	1	1	1	1	1	1	1	1	1	1	1	1	1	1	1	1	1	1	1	1	1	1	1	1	1	1	1	1	1	1	1
1	1	1	1	1	1	1	1	1	1	1	1	1	1	1	1	1	1	1	1	1	1	1	1	1	1	1	1	1	1	1	1	1	1	1	1	1	1	1	1	1
56 14 9
56 26 9
85 20 9
85 6 22
473 38 32
473 38 33
473 38 34
747 6 23
748 14 10
749 20 10
750 26 10
17 128 736
17 160 736
17 224 736
17 256 736
17 384 320
17 416 320
17 480 320
17 512 320
17 576 320
17 608 320
17 672 320
17 704 320
17 768 320
17 800 320
17 864 320
17 896 320
17 1024 736
17 1056 736
17 1120 736
17 1152 736
7