45 73
29 30
23
31
0 0
1	1	1	1	1	1	1	1	1	1	1	1	1	1	1	1	1	1	1	1	1	1	1	1	1	1	1	1	1	1	1	1	1	1	1	1	1	1	1	1	1	1	1	1	1
1	1	1	1	1	1	1	1	1	1	1	1	1	1	1	1	1	1	1	1	1	1	1	1	1	1	1	1	1	1	1	1	1	1	1	1	1	1	1	1	1	1	1	1	1
1	1	1	1	1	1	1	1	1	1	1	1	1	1	1	1	1	1	1	1	1	1	1	1	1	1	1	1	1	1	1	1	1	1	1	1	1	1	1	1	1	1	1	1	1
1	1	1	1	1	1	1	1	1	1	1	1	1	1	1	1	1	1	1	1	1	1	1	1	1	1	1	30	30	30	30	30	30	30	30	30	30	30	30	30	30	30	1	1	1
1	1	1	1	1	1	1	1	1	1	1	1	1	1	1	1	1	1	1	1	1	1	1	1	1	1	1	30	31	31	31	31	31	31	31	31	31	31	31	31	31	30	1	1	1
1	1	1	1	1	1	1	1	1	1	1	1	1	1	1	1	1	1	1	1	1	1	1	1	1	1	1	30	31	31	31	31	31	31	31	31	31	31	31	31	31	30	1	1	1
1	1	1	1	1	1	1	1	1	1	1	1	1	1	1	1	1	1	1	1	1	1	1	1	1	1	1	30	31	31	31	31	31	31	31	31	31	31	31	31	31	30	1	1	1
1	1	1	1	1	1	1	1	1	1	1	1	1	1	1	1	1	1	1	1	1	1	1	1	1	1	1	30	39	39	39	39	39	39	39	39	39	39	39	39	39	30	1	1	1
1	1	1	1	1	1	1	1	1	1	1	1	1	1	1	1	1	1	1	1	1	1	1	1	1	1	1	30	39	39	39	39	39	39	39	39	39	39	39	39	39	30	1	1	1
1	1	1	1	1	1	1	1	1	1	1	1	1	1	1	1	1	1	1	1	1	1	1	1	1	1	1	30	30	39	39	39	39	39	39	39	39	39	39	39	39	30	1	1	1
1	1	1	1	1	1	1	1	1	1	1	1	1	1	1	1	1	1	1	1	1	1	1	1	1	1	1	31	31	39	39	39	39	39	39	39	39	39	39	39	39	30	1	1	1
1	1	1	1	1	1	1	1	1	1	1	1	1	1	1	1	1	1	1	1	1	1	1	1	1	1	1	31	31	39	39	39	39	39	39	39	39	39	39	39	39	30	1	1	1
1	1	1	1	1	1	1	1	1	1	1	1	1	1	1	1	1	1	1	1	1	1	1	1	1	1	1	31	31	39	39	39	39	39	39	39	39	39	39	39	39	31	1	1	1
1	1	1	1	1	1	1	1	1	1	1	1	1	1	1	1	1	1	1	1	1	1	1	1	1	1	0	39	39	39	39	39	39	39	39	39	39	39	39	39	39	31	1	1	1
1	1	1	1	1	1	1	1	1	1	1	1	1	1	1	1	1	1	1	1	1	1	1	1	1	1	1	30	30	39	39	39	39	39	39	39	39	39	39	39	39	31	1	1	1
1	1	1	1	1	1	1	1	1	1	1	1	1	1	1	1	1	1	1	1	1	1	1	1	1	1	1	1	30	39	39	39	39	39	39	39	39	39	39	39	39	39	0	1	1
1	1	1	1	1	1	1	1	1	1	1	1	1	1	1	1	1	1	1	1	1	1	30	30	30	30	30	30	30	39	39	39	39	39	39	39	39	39	39	39	39	30	1	1	1
1	1	1	1	1	1	1	1	1	1	1	1	1	1	1	1	1	1	1	1	1	1	30	31	31	31	31	31	31	39	39	39	39	39	39	39	39	39	39	39	39	30	1	1	1
1	1	1	1	1	1	1	1	1	1	1	1	1	1	1	1	1	1	1	1	1	1	30	31	31	31	31	31	31	39	39	39	39	39	39	39	39	39	39	39	39	30	1	1	1
1	1	1	1	1	1	1	1	1	1	1	1	1	1	1	1	1	1	1	1	1	1	30	39	39	39	39	39	1	39	39	39	39	39	39	39	39	39	39	39	39	30	1	1	1
1	1	1	1	1	1	1	1	1	1	1	1	1	1	1	1	1	1	1	1	1	1	30	39	39	39	39	39	1	39	39	39	39	39	39	39	39	39	39	39	39	30	1	1	1
1	1	1	1	1	1	1	1	1	1	1	1	1	1	1	1	1	1	1	1	1	1	30	39	39	39	39	39	1	39	39	39	39	39	39	39	39	39	39	39	39	30	1	1	1
1	1	1	1	1	1	1	1	1	1	1	1	1	1	1	1	1	1	1	1	1	1	30	39	39	39	39	39	1	39	39	39	39	39	39	39	39	39	39	39	39	30	1	1	1
1	1	1	1	1	1	1	1	1	1	1	1	1	1	1	1	1	1	1	1	1	1	30	39	39	39	39	39	1	39	39	39	39	39	39	39	39	39	39	39	39	30	1	1	1
1	1	1	1	1	1	1	1	1	1	1	1	1	1	1	1	1	1	1	1	1	1	30	30	30	30	30	30	30	39	39	39	39	39	39	39	39	39	39	39	39	30	1	1	1
1	1	1	1	1	1	1	1	1	1	1	1	1	1	1	1	1	1	1	1	1	1	30	31	31	31	31	31	31	39	39	39	39	39	39	39	39	39	39	39	39	30	1	1	1
1	1	1	1	1	1	1	1	1	1	1	1	1	1	1	1	1	1	1	1	1	1	30	31	31	31	31	31	31	39	39	39	39	39	39	39	39	39	39	39	39	30	1	1	1
1	1	1	1	1	1	1	1	1	1	1	1	1	1	1	1	1	1	1	1	1	1	30	39	39	39	39	39	1	39	39	39	39	39	39	39	39	39	39	39	39	30	1	1	1
1	1	1	1	1	1	1	1	1	1	1	1	1	1	1	1	1	1	1	1	1	1	30	39	39	39	39	39	1	39	39	39	39	39	39	39	39	39	39	39	39	30	1	1	1
1	1	1	1	1	1	1	1	1	1	1	1	1	1	1	1	1	1	1	1	1	1	30	39	39	39	39	39	1	39	39	39	39	39	39	39	39	39	39	39	39	30	1	1	1
1	1	1	1	1	1	1	1	1	1	1	1	1	1	1	1	1	1	1	1	1	1	30	39	39	39	39	39	1	39	39	39	39	39	39	39	39	39	39	39	39	30	1	1	1
1	1	1	1	1	1	1	1	1	1	1	1	1	1	1	1	1	1	1	1	1	1	30	39	39	39	39	39	1	39	39	39	39	39	39	39	39	39	39	39	39	30	1	1	1
1	1	1	1	1	1	1	1	1	1	1	1	1	1	1	1	1	1	1	1	1	1	30	30	30	30	30	30	30	39	39	39	39	39	39	39	39	39	39	39	39	30	1	1	1
1	1	1	1	1	1	1	1	1	1	1	1	1	1	1	1	1	1	1	1	1	1	30	31	31	31	31	31	31	39	39	39	39	39	39	39	39	39	39	39	39	30	1	1	1
1	1	1	1	1	1	1	1	1	1	1	1	1	1	1	1	1	1	1	1	1	1	30	31	31	31	31	31	31	39	39	39	39	39	39	39	39	39	39	39	39	30	1	1	1
1	1	1	1	1	1	1	1	1	1	1	1	1	1	1	1	1	1	1	1	1	1	30	39	39	39	39	39	1	39	39	39	39	39	39	39	39	39	39	39	39	30	1	1	1
1	1	1	1	1	1	1	1	1	1	1	1	1	1	1	1	1	1	1	1	1	1	30	39	39	39	39	39	1	39	39	39	39	39	39	39	39	39	39	39	39	30	1	1	1
1	1	1	1	1	1	1	1	1	1	1	1	1	1	1	1	1	1	1	1	1	1	30	39	39	39	39	39	1	39	39	39	39	39	39	39	39	39	39	39	39	30	1	1	1
1	1	1	1	1	1	1	1	1	1	1	1	1	1	1	1	1	1	1	1	1	1	30	39	39	39	39	39	1	39	39	39	39	39	39	39	39	39	39	39	39	30	1	1	1
1	1	1	1	1	1	1	1	1	1	1	1	1	1	1	1	1	1	1	1	1	1	30	39	39	39	39	39	1	39	39	39	39	39	39	39	39	39	39	39	39	30	1	1	1
1	1	1	1	1	1	1	1	1	1	1	1	1	1	1	1	1	1	1	1	1	1	30	30	30	30	30	30	30	39	39	39	39	39	39	39	39	39	39	39	39	30	1	1	1
1	1	1	1	30	30	30	30	30	30	30	30	30	30	30	30	30	30	30	30	30	30	30	31	31	31	31	31	30	39	39	39	39	39	39	39	39	39	39	39	39	30	1	1	1
1	1	1	1	30	31	31	31	31	31	30	31	31	31	31	31	30	31	31	31	31	31	30	31	31	31	31	31	30	39	39	39	39	39	39	39	39	39	39	39	39	30	1	1	1
1	1	1	1	30	31	31	31	31	31	30	31	31	31	31	31	30	31	31	31	31	31	30	31	0	31	31	31	30	39	39	39	39	39	39	39	39	39	39	39	39	30	1	1	1
1	1	1	1	30	31	31	0	31	31	30	31	31	0	31	31	30	31	31	0	31	31	30	39	39	39	39	39	30	39	39	39	39	39	39	39	39	39	39	39	39	30	1	1	1
1	1	1	30	30	39	39	39	39	39	30	39	39	39	39	39	30	39	39	39	39	39	30	39	39	39	39	39	30	39	39	39	39	39	39	39	39	39	39	39	39	30	1	1	1
1	1	1	30	31	39	39	39	39	39	31	39	39	39	39	39	31	39	39	39	39	39	31	39	39	39	39	39	31	39	39	39	39	39	39	39	39	39	39	39	39	30	1	1	1
1	1	1	30	31	39	39	39	39	39	31	39	39	39	39	39	31	39	39	39	39	39	31	39	39	39	39	39	31	39	39	39	39	39	39	39	39	39	39	39	39	30	1	1	1
1	1	1	30	31	1	1	1	1	1	31	1	1	1	1	1	31	1	1	1	1	1	31	1	1	1	1	1	31	39	39	39	39	39	39	39	39	39	39	39	39	30	1	1	1
1	1	1	30	39	39	39	39	39	39	39	39	39	39	39	39	39	39	39	39	39	39	39	39	39	39	39	39	39	39	39	39	39	39	39	39	39	39	39	39	39	30	1	1	1
1	1	1	30	39	39	39	39	39	39	39	39	39	39	39	39	39	39	39	39	39	39	39	39	39	39	39	39	39	39	39	39	39	39	39	39	39	39	39	39	39	30	1	1	1
1	1	1	30	39	39	39	39	39	39	39	39	39	39	39	39	39	39	39	39	39	39	39	39	39	39	39	39	39	39	39	39	39	39	39	39	39	39	39	39	39	30	1	1	1
1	1	1	31	39	39	39	39	39	39	39	39	39	39	39	39	39	39	39	39	39	39	39	39	39	39	39	39	39	39	39	39	39	39	39	39	39	39	39	39	39	30	1	1	1
1	1	1	31	39	39	39	39	39	39	39	39	39	39	39	39	39	39	39	39	39	39	39	39	39	39	39	39	39	39	39	39	39	39	39	39	39	39	39	39	39	30	1	1	1
1	1	1	31	39	39	39	39	39	39	39	39	39	39	39	39	39	39	39	39	39	39	39	39	39	39	39	39	39	39	39	39	39	39	39	39	39	39	39	39	39	30	1	1	1
1	1	0	39	39	39	39	39	39	39	39	39	39	39	39	39	39	39	39	39	39	39	39	39	39	39	39	39	39	39	39	39	39	39	39	39	39	39	39	39	39	30	1	1	1
1	1	0	39	39	39	39	39	39	39	39	39	39	39	39	39	39	39	39	39	39	39	39	39	39	39	39	39	39	39	39	39	39	39	39	39	39	39	39	39	39	30	1	1	1
1	1	0	39	39	39	39	39	39	39	39	39	39	39	39	39	39	39	39	39	39	39	39	39	39	39	39	39	39	39	39	39	39	39	39	39	39	39	39	39	39	30	1	1	1
1	1	1	30	39	39	39	39	39	39	39	39	39	39	39	39	39	39	39	39	39	39	39	39	39	39	39	39	39	39	39	39	39	39	39	39	39	39	39	39	39	30	1	1	1
1	1	1	30	39	39	39	39	39	39	39	39	39	39	39	39	39	39	39	39	39	39	39	39	39	39	39	39	39	39	39	39	39	39	39	39	39	39	39	39	39	30	1	1	1
1	1	1	30	39	39	39	39	39	39	39	39	39	39	39	39	39	39	39	39	39	39	39	39	39	39	39	39	39	39	39	39	39	39	39	39	39	39	39	39	39	30	1	1	1
1	1	1	30	30	30	30	30	30	30	30	30	30	30	30	30	30	30	30	30	30	30	30	30	30	30	30	30	30	39	39	39	39	39	39	39	39	39	39	39	39	30	1	1	1
1	1	1	1	1	1	1	1	1	1	1	1	1	1	1	1	1	1	1	1	1	1	1	1	1	1	1	1	30	39	39	39	39	39	39	39	39	39	39	39	39	30	1	1	1
1	1	1	1	1	1	1	1	1	1	1	1	1	1	1	1	1	1	1	1	1	1	1	1	1	1	1	1	30	39	39	39	39	39	39	39	39	39	39	39	39	30	1	1	1
1	1	1	1	1	1	1	1	1	1	1	1	1	1	1	1	1	1	1	1	1	1	1	1	1	1	1	1	30	30	30	30	30	39	30	30	30	30	30	30	30	30	1	1	1
1	1	1	1	1	1	1	1	1	1	1	1	1	1	1	1	1	1	1	1	1	1	1	1	1	1	1	1	1	1	1	1	30	39	30	1	1	1	1	1	1	1	1	1	1
1	1	1	1	1	1	1	1	1	1	1	1	1	1	1	1	1	1	1	1	1	1	1	1	1	1	1	1	1	1	1	1	1	0	1	1	1	1	1	1	1	1	1	1	1
1	1	1	1	1	1	1	1	1	1	1	1	1	1	1	1	1	1	1	1	1	1	1	1	1	1	1	1	1	1	1	1	1	1	1	1	1	1	1	1	1	1	1	1	1
1	1	1	1	1	1	1	1	1	1	1	1	1	1	1	1	1	1	1	1	1	1	1	1	1	1	1	1	1	1	1	1	1	1	1	1	1	1	1	1	1	1	1	1	1
1	1	1	1	1	1	1	1	1	1	1	1	1	1	1	1	1	1	1	1	1	1	1	1	1	1	1	1	1	1	1	1	1	1	1	1	1	1	1	1	1	1	1	1	1
1	1	1	1	1	1	1	1	1	1	1	1	1	1	1	1	1	1	1	1	1	1	1	1	1	1	1	1	1	1	1	1	1	1	1	1	1	1	1	1	1	1	1	1	1
1	1	1	1	1	1	1	1	1	1	1	1	1	1	1	1	1	1	1	1	1	1	1	1	1	1	1	1	1	1	1	1	1	1	1	1	1	1	1	1	1	1	1	1	1
1	1	1	1	1	1	1	1	1	1	1	1	1	1	1	1	1	1	1	1	1	1	1	1	1	1	1	1	1	1	1	1	1	1	1	1	1	1	1	1	1	1	1	1	1
85 25 47
56 19 47
85 13 47
56 7 47
78 27 21
78 27 29
76 27 37
446 33 66
447 42 15
448 34 6
449 26 13
456 2 55
456 2 56
456 2 57
740 28 21
741 28 29
742 28 37
743 25 48
744 19 48
745 13 48
746 7 48
752 40 12
753 29 12
17 160 1536
17 192 1536
17 256 1536
17 288 1536
17 352 1536
17 384 1536
17 448 1536
17 480 1536
17 544 1536
17 576 1536
17 640 1536
17 672 1536
17 736 1536
17 768 1536
17 832 1536
17 864 1536
15 896 576
15 896 608
15 896 640
15 896 704
15 896 736
15 896 832
15 896 864
15 896 896
15 896 960
15 896 992
15 896 1088
15 896 1120
15 896 1152
15 896 1216
15 896 1248
7