30 29
22 24
3
0
0 0
1	1	1	1	1	1	1	1	1	1	1	1	1	1	1	1	1	1	1	1	1	1	1	1	1	1	1	1	1	1
1	1	1	1	1	1	1	1	1	1	1	1	1	1	1	1	1	1	1	1	1	1	1	1	1	1	1	1	1	1
1	1	1	1	1	1	1	1	1	1	1	1	1	1	1	1	1	1	1	1	1	1	1	1	1	1	1	1	1	1
1	1	1	1	1	1	1	1	1	1	1	1	1	1	1	1	1	1	1	30	30	30	30	30	30	30	1	1	1	1
1	1	1	1	1	1	1	1	1	1	1	1	1	1	1	1	1	1	1	30	31	31	31	31	31	30	1	1	1	1
1	1	1	1	1	1	1	1	1	1	1	1	1	1	1	1	1	1	1	30	31	31	31	31	31	30	1	1	1	1
1	1	1	1	1	1	1	1	1	1	1	1	1	1	1	1	1	1	1	30	31	31	31	31	31	31	1	1	1	1
1	1	1	1	1	1	1	1	1	1	1	1	1	1	1	1	1	1	1	30	39	39	39	39	39	31	1	1	1	1
1	1	1	30	30	30	30	30	30	30	30	30	30	30	30	30	30	30	30	30	39	39	39	39	39	31	1	1	1	1
1	1	1	30	31	31	31	31	31	31	31	31	31	31	30	31	31	31	31	31	39	39	39	39	39	39	0	1	1	1
1	1	1	30	31	31	31	31	31	31	31	31	31	31	30	31	31	31	31	31	39	39	39	39	39	30	1	1	1	1
1	1	1	30	31	31	31	31	31	31	31	31	31	31	30	31	31	31	31	31	39	39	39	39	39	30	1	1	1	1
1	1	1	30	39	39	39	39	39	39	39	39	39	39	30	39	39	39	39	39	39	39	39	39	39	30	1	1	1	1
1	1	1	30	39	39	39	39	39	39	39	39	39	39	30	39	39	39	39	39	39	39	39	39	39	30	1	1	1	1
1	1	1	30	39	39	39	39	39	39	39	39	39	39	30	39	39	39	39	39	39	39	39	39	39	30	1	1	1	1
1	1	1	30	39	39	39	39	39	39	39	39	39	39	30	39	39	39	39	39	39	39	39	39	39	30	1	1	1	1
1	1	1	30	39	39	39	39	39	39	39	39	39	39	31	39	39	39	39	39	39	39	39	39	39	30	1	1	1	1
1	1	1	30	39	39	39	39	39	39	39	39	39	39	31	39	39	39	39	39	39	39	39	39	39	30	1	1	1	1
1	1	1	30	39	39	39	39	39	39	39	39	39	39	31	39	39	39	39	39	39	39	39	39	39	30	1	1	1	1
1	1	1	30	39	39	39	39	39	39	39	39	39	39	39	39	39	39	39	39	39	39	39	39	39	30	1	1	1	1
1	1	1	30	39	39	39	39	39	39	39	39	39	39	39	39	39	39	39	39	39	39	39	39	39	30	1	1	1	1
1	1	1	30	39	39	39	39	39	39	39	39	39	39	39	39	39	39	39	39	39	39	39	39	39	30	1	1	1	1
1	1	1	30	39	39	39	39	39	39	39	39	39	39	30	39	39	39	39	39	39	39	39	39	39	30	1	1	1	1
1	1	1	30	39	39	39	39	39	39	39	39	39	39	30	39	39	39	39	39	39	39	39	39	39	30	1	1	1	1
1	1	1	30	30	30	30	30	30	30	30	30	30	30	30	30	30	30	30	30	30	30	39	30	30	30	1	1	1	1
1	1	1	1	1	1	1	1	1	1	1	1	1	1	1	1	1	1	1	1	1	1	0	1	1	1	1	1	1	1
1	1	1	1	1	1	1	1	1	1	1	1	1	1	1	1	1	1	1	1	1	1	1	1	1	1	1	1	1	1
1	1	1	1	1	1	1	1	1	1	1	1	1	1	1	1	1	1	1	1	1	1	1	1	1	1	1	1	1	1
1	1	1	1	1	1	1	1	1	1	1	1	1	1	1	1	1	1	1	1	1	1	1	1	1	1	1	1	1	1
441 22 25
442 22 6
443 26 9
6