58 74
32 59
0
0
0 0
1	1	1	1	1	1	1	1	1	1	1	1	1	1	1	1	1	1	1	1	1	1	1	1	1	1	1	1	1	1	1	1	1	1	1	1	1	1	1	1	1	1	1	1	1	1	1	1	1	1	1	1	1	1	1	1	1	1
1	1	1	1	1	1	1	1	1	1	1	1	1	1	1	1	1	1	1	1	1	1	1	1	1	1	1	1	1	1	1	1	1	1	1	1	1	1	1	1	1	1	1	1	1	1	1	1	1	1	1	1	1	1	1	1	1	1
1	1	1	1	1	1	1	1	1	1	1	1	1	1	1	1	1	1	1	1	1	1	1	1	1	1	1	1	1	1	1	1	1	1	1	1	1	1	1	1	1	1	1	1	1	1	1	1	1	1	1	1	1	1	1	1	1	1
1	1	1	37	37	37	37	37	37	37	37	37	37	37	37	37	37	37	37	37	37	37	37	37	37	37	37	37	37	37	37	37	37	37	37	37	37	37	37	37	37	37	37	37	37	37	37	37	37	37	37	37	37	37	37	1	1	1
1	1	1	37	37	37	37	37	37	37	37	37	37	37	37	37	37	37	37	37	37	37	37	37	37	37	37	37	37	37	37	37	37	37	37	37	37	37	37	37	37	37	37	37	37	37	37	37	37	37	37	37	37	37	37	1	1	1
1	1	1	37	37	37	37	37	37	37	37	37	37	37	37	37	37	37	37	37	37	37	37	37	37	37	37	37	37	37	37	37	37	37	37	37	37	37	37	37	37	37	37	37	37	37	37	37	37	37	37	37	37	37	37	1	1	1
1	1	1	37	37	37	37	37	37	37	37	37	37	37	37	37	37	37	37	37	37	37	37	37	37	37	37	37	37	37	37	37	37	37	37	37	37	37	37	37	37	37	37	37	37	37	37	37	37	37	37	37	37	37	37	1	1	1
1	1	1	37	37	37	37	37	37	37	37	37	37	37	37	37	37	37	37	37	37	37	37	37	37	37	37	37	37	37	37	37	37	37	37	37	37	37	37	37	37	37	37	37	37	37	37	37	37	37	37	37	37	37	37	1	1	1
1	1	1	37	37	37	37	37	37	37	37	37	37	37	37	37	37	37	37	37	37	37	37	37	37	37	37	37	37	37	37	37	37	37	37	37	37	37	37	37	37	37	37	37	37	37	37	37	37	37	37	37	37	37	37	1	1	1
1	1	1	37	37	37	37	37	37	37	37	37	37	37	37	37	37	37	37	37	37	37	37	37	37	37	37	37	37	37	37	37	37	37	37	37	37	37	37	30	30	30	30	30	30	30	30	30	30	37	37	37	37	37	37	1	1	1
1	1	1	37	37	37	37	37	37	37	37	37	37	37	29	29	29	29	29	29	29	29	29	29	29	29	29	29	29	29	29	29	29	29	29	37	37	37	37	30	30	30	30	30	30	30	30	30	30	37	37	37	37	37	37	1	1	1
1	1	1	37	37	37	37	37	37	37	37	37	37	29	38	38	38	38	38	38	38	38	38	38	38	38	38	38	38	38	38	38	38	38	29	37	37	37	37	30	30	30	30	30	30	30	30	30	30	37	37	37	37	37	37	1	1	1
1	1	1	37	37	37	37	37	37	37	37	37	37	29	25	25	25	25	25	25	25	25	25	25	25	25	25	25	25	25	25	25	25	25	29	37	37	37	37	30	30	30	30	30	30	30	30	30	30	37	37	37	37	37	37	1	1	1
1	1	1	37	37	37	37	37	37	37	37	37	37	29	25	25	25	25	25	25	25	25	25	25	25	25	25	25	25	25	25	25	25	25	29	37	37	37	37	30	30	30	30	30	30	30	30	30	30	37	37	37	37	37	37	1	1	1
1	1	1	37	37	37	37	37	37	37	37	37	37	29	25	25	25	25	25	25	25	25	25	25	25	25	25	25	25	25	25	25	25	25	29	37	37	37	37	30	30	30	30	30	30	30	30	30	30	37	37	37	37	37	37	1	1	1
1	1	1	37	37	37	37	37	37	37	37	37	37	29	25	25	25	25	25	25	25	25	25	25	25	25	25	25	25	25	25	25	25	25	29	37	37	37	37	30	30	30	30	30	30	30	30	30	30	37	37	37	37	37	37	1	1	1	
1	1	1	37	37	37	37	37	37	37	37	37	37	29	25	25	25	25	25	29	29	29	29	29	29	29	29	29	29	25	25	25	25	25	29	37	37	37	37	30	30	30	30	30	30	30	30	30	30	37	37	37	37	37	37	1	1	1
1	1	1	37	37	37	37	37	37	37	37	37	37	29	25	25	25	25	25	29	37	37	37	37	37	37	37	37	29	25	25	25	25	25	29	37	37	37	37	30	30	30	30	30	30	30	30	30	30	37	37	37	37	37	37	1	1	1
1	1	1	37	37	37	37	37	37	37	37	37	37	29	25	25	25	25	25	29	37	37	37	37	37	37	37	37	29	25	25	25	25	25	29	37	37	37	37	31	31	31	31	31	31	31	31	31	31	37	37	37	37	37	37	1	1	1
1	1	1	37	37	37	37	37	37	37	37	37	37	29	25	25	25	25	25	29	37	37	37	37	37	37	37	37	29	25	25	25	25	25	29	37	37	37	37	31	31	31	31	31	31	31	31	31	31	37	37	37	37	37	37	1	1	1
1	1	1	37	37	37	37	37	37	37	37	37	37	29	25	25	25	25	25	29	37	37	37	37	37	37	37	37	29	25	25	25	25	25	29	29	29	29	29	31	31	31	31	31	31	31	31	31	31	37	37	37	37	37	37	1	1	1
1	1	1	37	37	37	37	37	37	37	37	37	37	29	25	25	25	25	25	29	37	37	37	37	37	37	37	37	29	25	25	25	25	25	38	38	38	38	38	31	31	31	31	31	31	31	31	31	31	37	37	37	37	37	37	1	1	1
1	1	1	37	37	37	37	37	37	37	37	37	37	29	25	25	25	25	25	29	37	30	30	37	30	30	37	37	29	25	25	25	25	25	25	25	25	25	25	31	31	31	31	31	31	31	31	31	31	37	37	37	37	37	37	1	1	1
1	1	1	37	37	37	37	37	37	37	37	37	37	29	25	25	25	25	25	29	37	30	30	30	30	30	37	37	29	25	25	25	25	25	25	25	25	25	25	31	31	31	31	31	31	31	31	31	31	37	37	37	37	37	37	1	1	1
1	1	1	37	37	37	37	37	37	37	37	37	37	29	25	25	25	25	25	29	37	30	30	30	30	30	37	37	29	25	25	25	25	25	25	25	25	25	25	31	31	31	31	31	31	31	31	31	31	37	37	37	37	37	37	1	1	1
1	1	1	37	37	37	37	37	37	37	37	37	37	29	25	25	25	25	25	29	37	30	30	30	30	30	37	37	29	25	25	25	25	25	25	25	25	25	25	31	31	31	31	31	31	31	31	31	31	37	37	37	37	37	37	1	1	1
1	1	1	37	37	37	37	37	37	37	37	37	37	29	25	25	25	25	25	29	37	30	30	30	30	30	37	37	37	29	29	29	29	29	29	29	29	29	29	37	37	37	37	37	37	37	37	37	37	37	37	37	37	37	37	1	1	1
1	1	1	37	37	37	37	37	37	37	37	37	37	29	25	25	25	25	25	29	37	30	30	30	30	30	37	37	37	37	37	37	37	37	37	37	37	37	37	37	37	37	37	37	37	37	37	37	37	37	37	37	37	37	37	1	1	1
1	1	1	37	37	37	37	37	37	37	37	37	37	29	25	25	25	25	25	29	37	31	31	31	31	31	37	37	37	37	37	37	37	37	37	37	37	37	37	37	37	37	37	37	37	37	37	37	37	37	37	37	37	37	37	1	1	1
1	1	1	37	37	37	37	37	37	37	37	37	37	29	25	25	25	25	25	29	37	31	31	31	31	31	37	37	37	37	37	37	37	37	37	37	37	37	37	37	37	37	37	37	37	37	37	37	37	37	37	37	37	37	37	1	1	1	
1	1	1	37	37	37	37	37	37	37	37	37	37	29	25	25	25	25	25	29	37	31	31	31	31	31	37	37	37	37	37	37	37	37	37	37	37	37	37	37	37	37	37	37	37	37	37	37	37	37	37	37	37	37	37	1	1	1
1	1	1	37	37	37	37	37	37	37	37	37	37	29	25	25	25	25	25	29	37	37	37	37	37	37	37	37	37	37	37	37	37	37	37	37	37	37	37	37	37	37	37	37	37	37	37	37	37	37	37	37	37	37	37	1	1	1
1	1	1	37	37	37	37	37	37	37	37	37	37	29	25	25	25	25	25	29	37	37	37	37	37	37	37	37	37	37	37	37	37	37	37	37	37	37	37	37	37	37	37	37	37	37	37	37	37	37	37	37	37	37	37	1	1	1
1	1	1	37	37	37	37	37	37	37	37	37	37	29	25	25	25	25	25	29	37	37	37	37	37	37	37	37	37	37	37	37	37	37	37	37	37	37	37	37	37	37	37	37	37	37	37	37	37	37	37	37	37	37	37	1	1	1
1	1	1	37	37	37	37	37	37	37	37	37	37	29	25	25	25	25	25	29	29	29	29	29	29	29	29	29	29	29	29	29	29	29	29	29	29	29	29	29	29	29	29	29	29	37	37	37	37	37	37	37	37	37	37	1	1	1	
1	1	1	37	37	37	37	37	37	37	37	37	37	29	25	25	25	25	25	38	38	38	38	38	38	38	38	38	38	38	38	38	38	38	38	38	38	38	38	38	38	38	38	38	29	37	37	37	37	37	37	37	37	37	37	1	1	1
1	1	1	37	37	37	37	37	37	37	37	37	37	29	25	25	25	25	25	25	25	25	25	25	25	25	25	25	25	25	25	25	25	25	25	25	25	25	25	25	25	25	25	25	29	37	37	37	37	37	37	37	37	37	37	1	1	1	
1	1	1	37	37	37	37	37	37	37	37	37	37	29	25	25	25	25	25	25	25	25	25	25	25	25	25	25	25	25	25	25	25	25	25	25	25	25	25	25	25	25	25	25	29	37	37	37	37	37	37	37	37	37	37	1	1	1
1	1	1	37	37	37	37	37	37	37	37	37	37	29	25	25	25	25	25	25	25	25	25	25	25	25	25	25	25	25	25	25	25	25	25	25	25	25	25	25	25	25	25	25	29	37	37	37	37	37	37	37	37	37	37	1	1	1
1	1	1	37	37	37	37	37	37	37	37	37	37	29	25	25	25	25	25	25	25	25	25	25	25	25	25	25	25	25	25	25	25	25	25	25	25	25	25	25	25	25	25	25	29	37	37	37	37	37	37	37	37	37	37	1	1	1
1	1	1	37	37	37	37	37	37	37	37	37	37	37	29	29	29	29	29	29	29	29	29	29	29	29	29	29	29	25	25	25	25	25	29	29	29	29	29	29	29	29	29	29	29	37	37	37	37	37	37	37	37	37	37	1	1	1
1	1	1	37	37	37	37	37	37	37	37	37	37	37	37	37	37	37	37	37	37	37	37	37	37	37	37	37	29	25	25	25	25	25	29	37	37	37	37	37	37	37	37	37	37	37	37	37	37	37	37	37	37	37	37	1	1	1
1	1	1	37	37	37	37	37	37	37	37	37	37	37	37	37	37	37	37	37	37	37	37	37	37	37	37	37	29	25	25	25	25	25	29	37	37	37	37	37	37	37	37	37	37	37	37	37	37	37	37	37	37	37	37	1	1	1
1	1	1	37	37	37	37	37	37	37	37	37	37	37	37	37	37	37	37	37	37	37	37	37	37	37	37	37	29	25	25	25	25	25	29	37	37	37	37	37	37	37	37	37	37	37	37	37	37	37	37	37	37	37	37	1	1	1
1	1	1	37	37	37	37	37	37	37	37	37	37	37	37	37	37	37	37	37	37	37	37	37	37	37	37	37	29	25	25	25	25	25	29	37	37	37	37	37	37	37	37	37	37	37	37	37	37	37	37	37	37	37	37	1	1	1
1	1	1	37	37	37	37	37	37	37	37	37	37	37	37	37	37	37	37	37	37	37	37	37	37	37	37	37	29	25	25	25	25	25	29	37	37	37	37	37	37	37	37	37	37	37	37	37	37	37	37	37	37	37	37	1	1	1
1	1	1	37	37	37	37	37	37	37	37	37	37	37	37	37	37	37	37	37	37	37	37	37	37	37	37	37	29	25	25	25	25	25	29	37	37	37	37	37	37	37	37	37	37	37	37	37	37	37	37	37	37	37	37	1	1	1
1	1	1	37	37	37	37	37	37	37	37	37	37	37	37	37	37	37	37	37	37	37	37	37	37	37	37	37	29	25	25	25	25	25	29	37	37	37	37	37	37	37	37	37	37	37	37	37	37	37	37	37	37	37	37	1	1	1
1	1	1	37	37	37	37	37	37	37	37	37	37	37	37	37	37	37	37	37	37	37	37	37	37	37	37	37	29	25	25	25	25	25	29	37	37	37	37	37	37	37	37	37	37	37	37	37	37	37	37	37	37	37	37	1	1	1
1	1	1	37	37	37	37	37	37	37	37	37	37	37	37	37	37	37	37	37	37	37	37	37	37	37	37	37	29	25	25	25	25	25	29	37	37	37	37	37	37	37	37	37	37	37	37	37	37	37	37	37	37	37	37	1	1	1
1	1	1	37	37	37	37	37	37	37	37	37	37	37	37	37	37	37	37	37	37	37	37	37	37	37	37	37	29	25	25	25	25	25	29	37	37	37	37	37	37	37	37	37	37	37	37	37	37	37	37	37	37	37	37	1	1	1
1	1	1	37	37	37	37	37	37	37	37	37	37	37	37	37	37	37	37	37	37	37	37	37	37	37	37	37	29	25	25	25	25	25	29	37	37	37	37	37	37	37	37	37	37	37	37	37	37	37	37	37	37	37	37	1	1	1
1	1	1	37	37	37	37	37	37	37	37	37	37	37	37	37	37	37	37	37	37	37	37	37	37	37	37	37	29	25	25	25	25	25	29	37	37	37	37	37	37	37	37	37	37	37	37	37	37	37	37	37	37	37	37	1	1	1
1	1	1	37	37	37	37	37	37	37	37	37	37	37	37	37	37	37	37	37	37	37	37	37	37	37	37	37	29	25	25	25	25	25	29	37	37	37	37	37	37	37	37	37	37	37	37	37	37	37	37	37	37	37	37	1	1	1
1	1	1	37	37	37	37	37	37	37	37	37	37	37	37	37	37	37	37	37	37	37	37	37	37	37	37	37	29	25	25	25	25	25	29	37	37	37	37	37	37	37	37	37	37	37	37	37	37	37	37	37	37	37	37	1	1	1
1	1	1	37	37	37	37	37	37	37	37	37	37	37	37	37	37	37	37	37	37	37	37	37	37	37	37	37	29	25	25	25	25	25	29	37	37	37	37	37	37	37	37	37	37	37	37	37	37	37	37	37	37	37	37	1	1	1
1	1	1	37	37	37	37	37	37	37	37	37	37	37	37	37	37	37	37	37	37	37	37	37	37	37	37	37	29	25	25	25	25	25	29	37	37	37	37	37	37	37	37	37	37	37	37	37	37	37	37	37	37	37	37	1	1	1
1	1	1	37	37	37	37	37	37	37	37	37	37	37	37	37	37	37	37	37	37	37	37	37	37	37	37	37	29	25	25	25	25	25	29	37	37	37	37	37	37	37	37	37	37	37	37	37	37	37	37	37	37	37	37	1	1	1
1	1	1	37	37	37	37	37	37	37	37	37	37	37	37	37	37	37	37	37	37	37	37	37	37	37	37	37	29	25	25	25	25	25	29	37	37	37	37	37	37	37	37	37	37	37	37	37	37	37	37	37	37	37	37	1	1	1
1	1	1	37	37	37	37	37	37	37	37	37	37	37	37	37	37	37	37	37	37	37	37	37	37	37	37	37	29	25	25	25	25	25	29	37	37	37	37	37	37	37	37	37	37	37	37	37	37	37	37	37	37	37	37	1	1	1
1	1	1	37	37	37	37	37	37	37	37	37	37	37	37	37	37	37	37	37	37	37	37	37	37	37	37	37	30	30	30	25	30	30	30	37	37	37	37	37	37	37	37	37	37	37	37	37	37	37	37	37	37	37	37	1	1	1
1	1	1	37	37	37	37	37	37	37	37	37	37	37	37	37	37	37	37	37	37	37	37	37	37	37	37	37	30	30	30	30	30	30	30	37	37	37	37	37	37	37	37	37	37	37	37	37	37	37	37	37	37	37	37	1	1	1
1	1	1	37	37	37	37	37	37	37	37	37	37	37	37	37	37	37	37	37	37	37	37	37	37	37	37	37	30	30	30	30	30	30	30	37	37	37	37	37	37	37	37	37	37	37	37	37	37	37	37	37	37	37	37	1	1	1
1	1	1	37	37	37	37	37	37	37	37	37	37	37	37	37	37	37	37	37	37	37	37	37	37	37	37	37	30	30	30	30	30	30	30	37	37	37	37	37	37	37	37	37	37	37	37	37	37	37	37	37	37	37	37	1	1	1
1	1	1	37	37	37	37	37	37	37	37	37	37	37	37	37	37	37	37	37	37	37	37	37	37	37	37	37	30	30	30	30	30	30	30	37	37	37	37	37	37	37	37	37	37	37	37	37	37	37	37	37	37	37	37	1	1	1
1	1	1	37	37	37	37	37	37	37	37	37	37	37	37	37	37	37	37	37	37	37	37	30	30	30	30	30	30	30	30	30	30	30	30	30	30	30	30	30	37	37	37	37	37	37	37	37	37	37	37	37	37	37	37	1	1	1
1	1	1	37	37	37	37	37	37	37	37	37	37	37	37	37	37	37	37	37	37	37	37	30	30	30	30	30	30	30	30	30	30	30	30	30	30	30	30	30	37	37	37	37	37	37	37	37	37	37	37	37	37	37	37	1	1	1
1	1	1	37	37	37	37	37	37	37	37	37	37	37	37	37	37	37	37	37	37	37	37	30	30	30	30	30	30	30	30	30	30	30	30	30	30	30	30	30	37	37	37	37	37	37	37	37	37	37	37	37	37	37	37	1	1	1
1	1	1	37	37	37	37	37	37	37	37	37	37	37	37	37	37	37	37	37	37	37	37	30	30	30	30	30	30	30	30	30	30	30	30	30	30	30	30	30	37	37	37	37	37	37	37	37	37	37	37	37	37	37	37	1	1	1
1	1	1	37	37	37	37	37	37	37	37	37	37	37	37	37	37	37	37	37	37	37	37	30	30	30	30	30	30	30	30	30	30	30	30	30	30	30	30	30	37	37	37	37	37	37	37	37	37	37	37	37	37	37	37	1	1	1
1	1	1	37	37	37	37	37	37	37	37	37	37	37	37	37	37	37	37	37	37	37	37	30	30	30	30	30	30	30	30	30	30	30	30	30	30	30	30	30	37	37	37	37	37	37	37	37	37	37	37	37	37	37	37	1	1	1
1	1	1	1	1	1	1	1	1	1	1	1	1	1	1	1	1	1	1	1	1	1	1	1	1	1	1	1	1	1	1	1	1	1	1	1	1	1	1	1	1	1	1	1	1	1	1	1	1	1	1	1	1	1	1	1	1	1
1	1	1	1	1	1	1	1	1	1	1	1	1	1	1	1	1	1	1	1	1	1	1	1	1	1	1	1	1	1	1	1	1	1	1	1	1	1	1	1	1	1	1	1	1	1	1	1	1	1	1	1	1	1	1	1	1	1
1	1	1	1	1	1	1	1	1	1	1	1	1	1	1	1	1	1	1	1	1	1	1	1	1	1	1	1	1	1	1	1	1	1	1	1	1	1	1	1	1	1	1	1	1	1	1	1	1	1	1	1	1	1	1	1	1	1
