45 37
13 16
6
6
0 0
1	1	1	1	1	1	1	1	1	1	1	1	1	1	1	1	1	1	1	1	1	1	1	1	1	1	1	1	1	1	1	1	1	1	1	1	1	1	1	1	1	1	1	1	1
1	1	1	1	1	1	1	1	1	1	1	1	1	1	1	1	1	1	1	1	1	1	1	1	1	1	1	1	1	1	1	1	1	1	1	1	1	1	1	1	1	1	1	1	1
1	1	1	1	1	1	1	1	1	1	1	1	1	1	1	1	1	1	1	1	1	1	1	1	1	1	1	1	1	1	1	1	1	1	1	1	1	1	1	1	1	1	1	1	1
1	1	1	30	30	30	30	30	30	30	30	30	30	37	37	37	37	37	37	37	37	37	37	37	37	37	37	37	37	30	30	30	30	30	30	30	30	30	30	37	37	37	1	1	1
1	1	1	30	30	30	30	30	30	30	30	30	30	37	37	37	37	37	37	37	37	37	37	37	37	37	37	37	37	30	30	30	30	30	30	30	30	30	30	37	37	37	1	1	1
1	1	1	30	30	30	30	30	30	30	30	30	30	37	37	37	37	37	37	37	37	37	37	37	37	37	37	37	37	30	30	30	30	30	30	30	30	30	30	37	37	37	1	1	1
1	1	1	30	30	30	30	30	30	30	30	30	30	37	37	37	37	37	37	37	37	37	37	37	37	37	37	37	37	30	30	30	30	30	30	30	30	30	30	37	37	37	1	1	1
1	1	1	30	30	30	30	30	30	30	30	30	30	37	37	37	37	37	37	37	37	37	37	37	37	37	37	37	37	30	30	30	30	30	30	30	30	30	30	37	37	37	1	1	1
1	1	1	30	30	30	30	30	30	30	30	30	30	37	37	37	37	37	37	37	37	37	37	37	37	37	37	37	37	30	30	30	30	30	30	30	30	30	30	30	30	30	1	1	1
1	1	1	30	30	30	30	30	30	30	30	30	30	37	37	37	37	37	37	37	37	37	37	37	37	37	37	37	37	31	31	31	31	31	31	31	31	31	31	31	31	31	1	1	1
1	1	1	30	30	30	30	30	30	30	30	30	30	37	37	37	37	37	37	37	37	37	37	37	37	37	37	37	37	31	31	31	31	31	31	31	31	31	31	31	31	31	1	1	1
1	1	1	31	31	31	31	31	31	31	31	31	31	37	37	37	37	37	37	37	37	37	37	37	37	37	37	37	37	31	31	31	31	31	31	31	31	31	31	31	31	31	1	1	1
1	1	1	31	31	31	31	31	31	31	31	31	31	37	37	37	37	37	37	37	37	37	37	37	37	37	37	37	37	31	31	31	31	31	31	31	31	31	31	31	31	31	1	1	1
1	1	1	31	31	31	31	31	31	31	31	31	31	37	37	37	37	37	37	37	37	37	37	37	37	37	37	37	37	31	31	31	31	31	31	31	31	31	31	31	31	31	1	1	1
1	1	1	31	31	31	31	31	31	31	31	31	31	38	38	38	38	38	38	38	38	38	38	38	38	38	38	38	38	25	25	25	25	29	29	37	37	37	37	37	37	37	1	1	1
1	1	1	31	31	31	31	31	31	31	31	31	31	25	25	25	25	25	25	25	25	25	25	25	25	25	25	25	25	25	25	25	25	29	29	37	37	37	37	37	37	37	1	1	1
1	1	1	31	31	31	31	31	31	31	31	31	31	25	25	25	25	25	25	25	25	25	25	25	25	25	25	25	25	25	25	25	25	29	29	37	37	37	37	37	37	37	1	1	1
1	1	1	31	31	31	31	31	31	31	31	31	31	25	25	25	25	25	25	25	25	25	25	25	25	25	25	25	25	25	25	25	25	29	29	37	37	37	37	37	37	37	1	1	1
1	1	1	31	31	31	31	31	31	31	31	31	31	25	25	25	25	25	25	25	25	25	25	25	25	25	25	25	25	25	25	25	25	29	29	37	37	37	37	37	37	37	1	1	1
1	1	1	31	31	31	31	31	31	31	31	31	31	29	29	29	29	29	29	29	29	29	29	29	29	29	29	29	29	30	30	25	30	30	37	37	34	34	34	34	34	34	1	1	1
1	1	1	31	31	31	31	31	31	31	31	31	31	37	37	37	37	37	37	37	37	37	37	37	37	37	37	37	37	30	30	30	30	30	37	37	34	1	1	1	1	1	1	1	1
1	1	1	31	31	31	31	31	31	31	31	31	31	37	37	37	37	37	37	37	37	37	37	37	37	37	37	37	37	30	30	30	30	30	37	37	34	1	1	1	1	1	1	1	1
1	1	1	31	31	31	31	31	31	31	31	31	31	37	37	37	37	37	37	37	37	37	37	37	37	37	37	37	37	30	30	30	30	30	37	37	34	1	1	1	1	1	1	1	1
1	1	1	31	31	31	31	31	31	31	31	31	31	37	37	37	37	37	37	37	37	37	37	37	37	37	37	37	37	30	30	30	30	30	37	37	34	1	1	1	1	1	1	1	1
1	1	1	31	31	31	31	31	31	31	31	31	31	37	37	37	37	37	37	37	37	37	37	37	37	37	37	37	37	31	31	31	31	31	37	37	34	1	1	1	1	1	1	1	1
1	1	1	31	31	31	31	31	31	31	31	31	31	37	37	37	37	37	37	37	37	37	37	37	37	37	37	37	37	31	31	31	31	31	37	37	34	1	1	1	1	1	1	1	1
1	1	1	31	31	31	31	31	31	31	31	31	31	37	37	37	37	37	37	37	37	37	37	37	37	37	37	37	37	31	31	31	31	31	37	37	34	1	1	1	1	1	1	1	1
1	1	1	31	31	31	31	31	31	31	31	31	31	37	37	37	37	37	37	37	37	37	37	37	37	37	37	37	37	31	31	31	31	31	37	37	34	1	1	1	1	1	1	1	1
1	1	1	31	31	31	31	31	31	31	31	31	31	37	37	37	37	37	37	37	37	37	37	37	37	37	37	37	37	37	37	37	37	37	37	37	34	1	1	1	1	1	1	1	1
1	1	1	31	31	31	31	31	31	31	31	31	31	37	37	37	37	37	37	37	37	37	37	37	37	37	37	37	37	37	37	37	37	37	37	37	34	1	1	1	1	1	1	1	1
1	1	1	31	31	31	31	31	31	31	31	31	31	37	37	37	37	37	37	37	37	37	37	37	37	37	37	37	37	37	37	37	37	37	37	37	34	1	1	1	1	1	1	1	1
1	1	1	31	31	31	31	31	31	31	31	31	31	37	37	37	37	37	37	37	37	37	37	37	37	37	37	37	37	37	37	37	37	37	37	37	34	1	1	1	1	1	1	1	1
1	1	1	31	31	31	31	31	31	31	31	31	31	37	37	37	37	37	37	37	37	37	37	37	37	37	37	37	37	37	37	37	37	37	37	37	34	1	1	1	1	1	1	1	1
1	1	1	31	31	31	31	31	31	31	31	31	31	37	37	37	37	37	37	37	37	37	37	37	37	37	37	37	37	37	37	37	37	37	37	37	34	1	1	1	1	1	1	1	1
1	1	1	1	1	1	1	1	1	1	1	1	1	1	1	1	1	1	1	1	1	1	1	1	1	1	1	1	1	1	1	1	1	1	1	1	1	1	1	1	1	1	1	1	1
1	1	1	1	1	1	1	1	1	1	1	1	1	1	1	1	1	1	1	1	1	1	1	1	1	1	1	1	1	1	1	1	1	1	1	1	1	1	1	1	1	1	1	1	1
1	1	1	1	1	1	1	1	1	1	1	1	1	1	1	1	1	1	1	1	1	1	1	1	1	1	1	1	1	1	1	1	1	1	1	1	1	1	1	1	1	1	1	1	1
413 12 15
413 12 16
413 12 17
413 12 18
414 31 19
415 31 13
65 416 416
65 512 416
65 608 416
65 704 416
65 800 416
67 862 440
6