58 74
31 60
5
30
0 0
1	1	1	1	1	1	1	1	1	1	1	1	1	1	1	1	1	1	1	1	1	1	1	1	1	1	1	1	1	1	1	1	1	1	1	1	1	1	1	1	1	1	1	1	1	1	1	1	1	1	1	1	1	1	1	1	1	1
1	1	1	1	1	1	1	1	1	1	1	1	1	1	1	1	1	1	1	1	1	1	1	1	1	1	1	1	1	1	1	1	1	1	1	1	1	1	1	1	1	1	1	1	1	1	1	1	1	1	1	1	1	1	1	1	1	1
1	1	1	1	1	1	1	1	1	1	1	1	1	1	1	1	1	1	1	1	1	1	1	1	1	1	1	1	1	1	1	1	1	1	1	1	1	1	1	1	1	1	1	1	1	1	1	1	1	1	1	1	1	1	1	1	1	1
1	1	1	37	37	37	37	37	37	37	37	37	37	37	37	37	37	37	37	37	37	37	37	37	37	37	37	37	37	37	37	37	37	37	37	37	37	37	37	37	37	37	37	37	37	37	37	37	37	37	37	37	37	37	37	1	1	1
1	1	1	37	37	37	37	37	37	37	37	37	37	37	37	37	37	37	37	37	37	37	37	37	37	37	37	37	37	37	37	37	37	37	37	37	37	37	37	37	37	37	37	37	37	37	37	37	37	37	37	37	37	37	37	1	1	1
1	1	1	37	37	37	37	37	37	37	37	37	37	37	37	37	37	37	37	37	37	37	37	37	37	37	37	37	37	37	37	37	37	37	37	37	37	37	37	37	37	37	37	37	37	37	37	37	37	37	37	37	37	37	37	1	1	1
1	1	1	37	37	37	37	37	37	37	37	37	37	37	37	37	37	37	37	37	37	37	37	37	37	37	37	37	37	37	37	37	37	37	37	37	37	37	37	37	37	37	37	37	37	37	37	37	37	37	37	37	37	37	37	1	1	1
1	1	1	37	37	37	37	37	37	37	37	37	37	37	37	37	37	37	37	37	37	37	37	37	37	37	37	37	37	37	37	37	37	37	37	37	37	37	37	37	37	37	37	37	37	37	37	37	37	37	37	37	37	37	37	1	1	1
1	1	1	37	37	37	37	37	37	37	37	37	37	37	37	37	37	37	37	37	37	37	37	37	37	37	37	37	37	37	37	37	37	37	37	37	37	37	37	37	37	37	37	37	37	37	37	37	37	37	37	37	37	37	37	1	1	1
1	1	1	37	37	37	37	37	37	37	37	37	37	37	37	37	37	37	37	37	37	37	37	37	37	37	37	37	37	37	37	37	37	37	37	37	37	37	37	37	30	30	30	30	30	30	30	30	30	37	37	37	37	37	37	1	1	1
1	1	1	37	37	37	37	37	37	37	37	37	37	37	37	37	37	37	37	37	37	37	37	37	37	37	37	37	37	37	37	37	37	37	37	37	37	37	37	37	30	30	30	30	30	30	30	30	30	37	37	37	37	37	37	1	1	1
1	1	1	37	37	37	37	37	37	37	37	37	37	37	37	29	29	29	29	29	29	29	29	29	29	29	29	29	29	29	29	29	29	29	29	37	37	37	37	37	30	30	30	30	30	30	30	30	30	37	37	37	37	37	37	1	1	1
1	1	1	37	37	37	37	37	37	37	37	37	37	37	29	38	38	38	38	38	38	38	38	38	38	38	38	38	38	38	38	38	38	38	29	37	37	37	37	37	30	30	30	30	30	30	30	30	30	37	37	37	37	37	37	1	1	1
1	1	1	37	37	37	37	37	37	37	37	37	37	37	29	25	25	25	25	25	25	25	25	25	25	25	25	25	25	25	25	25	25	25	29	37	37	37	37	37	30	30	30	30	30	30	30	30	30	37	37	37	37	37	37	1	1	1
1	1	1	37	37	37	37	37	37	37	37	37	37	37	29	25	25	25	25	25	25	25	25	25	25	25	25	25	25	25	25	25	25	25	29	37	37	37	37	37	30	30	30	30	30	30	30	30	30	37	37	37	37	37	37	1	1	1
1	1	1	37	37	37	37	37	37	37	37	37	37	37	29	25	25	25	25	25	25	25	25	25	25	25	25	25	25	25	25	25	25	25	29	37	37	37	37	37	30	30	30	30	30	30	30	30	30	37	37	37	37	37	37	1	1	1	
1	1	1	37	37	37	37	37	37	37	37	37	37	37	29	25	25	25	25	25	25	25	25	25	25	25	25	25	25	25	25	25	25	25	29	37	37	37	37	37	30	30	30	30	30	30	30	30	30	37	37	37	37	37	37	1	1	1
1	1	1	37	37	37	37	37	37	37	37	37	37	37	29	25	25	25	25	25	29	29	29	29	29	29	29	29	29	25	25	25	25	25	29	37	37	37	37	37	30	30	30	30	30	30	30	30	30	37	37	37	37	37	37	1	1	1
1	1	1	37	37	37	37	37	37	37	37	37	37	37	29	25	25	25	25	25	29	37	37	37	37	37	37	37	29	25	25	25	25	25	29	37	37	37	37	37	31	31	31	31	31	31	31	31	31	37	37	37	37	37	37	1	1	1
1	1	1	37	37	37	37	37	37	37	37	37	37	37	29	25	25	25	25	25	29	37	37	37	37	37	37	37	29	25	25	25	25	25	29	29	29	29	29	29	31	31	31	31	31	31	31	31	31	37	37	37	37	37	37	1	1	1
1	1	1	37	37	37	37	37	37	37	37	37	37	37	29	25	25	25	25	25	29	37	37	37	37	37	37	37	29	25	25	25	25	25	38	38	38	38	38	25	31	31	31	31	31	31	31	31	31	37	37	37	37	37	37	1	1	1
1	1	1	37	37	37	37	37	37	37	37	37	37	37	29	25	25	25	25	25	29	37	37	37	37	37	37	37	29	25	25	25	25	25	25	25	25	25	25	25	31	31	31	31	31	31	31	31	31	37	37	37	37	37	37	1	1	1
1	1	1	37	37	37	37	37	37	37	37	37	37	37	29	25	25	25	25	25	29	37	30	30	37	30	30	37	29	25	25	25	25	25	25	25	25	25	25	25	31	31	31	31	31	31	31	31	31	37	37	37	37	37	37	1	1	1
1	1	1	37	37	37	37	37	37	37	37	37	37	37	29	25	25	25	25	25	29	37	30	30	30	30	30	37	29	25	25	25	25	25	25	25	25	25	25	25	31	31	31	31	31	31	31	31	31	37	37	37	37	37	37	1	1	1
1	1	1	37	37	37	37	37	37	37	37	37	37	37	29	25	25	25	25	25	29	37	30	30	30	30	30	37	29	25	25	25	25	25	25	25	25	25	25	25	31	31	31	31	31	31	31	31	31	37	37	37	37	37	37	1	1	1
1	1	1	37	37	37	37	37	37	37	37	37	37	37	29	25	25	25	25	25	29	37	30	30	30	30	30	37	29	29	29	29	29	29	29	29	29	29	29	29	31	31	31	31	31	31	31	31	31	37	37	37	37	37	37	1	1	1
1	1	1	37	37	37	37	37	37	37	37	37	37	37	29	25	25	25	25	25	29	37	30	30	30	30	30	37	37	37	37	37	37	37	37	37	37	37	37	37	37	37	37	37	37	37	37	37	37	37	37	37	37	37	37	1	1	1
1	1	1	37	37	37	37	37	37	37	37	37	37	37	29	25	25	25	25	25	29	37	30	30	30	30	30	37	37	37	37	37	37	37	37	37	37	37	37	37	37	37	37	37	37	37	37	37	37	37	37	37	37	37	37	1	1	1
1	1	1	37	37	37	37	37	37	37	37	37	37	37	29	25	25	25	25	25	29	37	31	31	31	31	31	37	37	37	37	37	37	37	37	37	37	37	37	37	37	37	37	37	37	37	37	37	37	37	37	37	37	37	37	1	1	1
1	1	1	37	37	37	37	37	37	37	37	37	37	37	29	25	25	25	25	25	29	37	31	31	31	31	31	37	37	37	37	37	37	37	37	37	37	37	37	37	37	37	37	37	37	37	37	37	37	37	37	37	37	37	37	1	1	1	
1	1	1	37	37	37	37	37	37	37	37	37	37	37	29	25	25	25	25	25	29	37	31	31	31	31	31	37	37	37	37	37	37	37	37	37	37	37	37	37	37	37	37	37	37	37	37	37	37	37	37	37	37	37	37	1	1	1
1	1	1	37	37	37	37	37	37	37	37	37	37	37	29	25	25	25	25	25	29	37	37	37	37	37	37	37	37	37	37	37	37	37	37	37	37	37	37	37	37	37	37	37	37	37	37	37	37	37	37	37	37	37	37	1	1	1
1	1	1	37	37	37	37	37	37	37	37	37	37	37	29	25	25	25	25	25	29	37	37	37	37	37	37	37	37	37	37	37	37	37	37	37	37	37	37	37	37	37	37	37	37	37	37	37	37	37	37	37	37	37	37	1	1	1
1	1	1	37	37	37	37	37	37	37	37	37	37	37	29	25	25	25	25	25	29	37	37	37	37	37	37	37	37	37	37	37	37	37	37	37	37	37	37	37	37	37	37	37	37	37	37	37	37	37	37	37	37	37	37	1	1	1
1	1	1	37	37	37	37	37	37	37	37	37	37	37	29	25	25	25	25	25	29	29	29	29	29	29	29	29	29	29	29	29	29	29	29	29	29	29	29	29	29	29	29	29	29	37	37	37	37	37	37	37	37	37	37	1	1	1	
1	1	1	37	37	37	37	37	37	37	37	37	37	37	29	25	25	25	25	25	38	38	38	38	38	38	38	38	38	38	38	38	38	38	38	38	38	38	38	38	38	38	38	38	38	37	37	37	37	37	37	37	37	37	37	1	1	1
1	1	1	37	37	37	37	37	37	37	37	37	37	37	29	25	25	25	25	25	25	25	25	25	25	25	25	25	25	25	25	25	25	25	25	25	25	25	25	25	25	25	25	25	25	29	37	37	37	37	37	37	37	37	37	1	1	1	
1	1	1	37	37	37	37	37	37	37	37	37	37	37	29	25	25	25	25	25	25	25	25	25	25	25	25	25	25	25	25	25	25	25	25	25	25	25	25	25	25	25	25	25	25	29	37	37	37	37	37	37	37	37	37	1	1	1
1	1	1	37	37	37	37	37	37	37	37	37	37	37	29	25	25	25	25	25	25	25	25	25	25	25	25	25	25	25	25	25	25	25	25	25	25	25	25	25	25	25	25	25	25	29	37	37	37	37	37	37	37	37	37	1	1	1
1	1	1	37	37	37	37	37	37	37	37	37	37	37	29	25	25	25	25	25	25	25	25	25	25	25	25	25	25	25	25	25	25	25	25	25	25	25	25	25	25	25	25	25	25	29	37	37	37	37	37	37	37	37	37	1	1	1
1	1	1	37	37	37	37	37	37	37	37	37	37	37	37	29	29	29	29	29	29	29	29	29	29	29	29	29	29	25	25	25	25	25	29	29	29	29	29	29	29	29	29	29	29	37	37	37	37	37	37	37	37	37	37	1	1	1
1	1	1	37	37	37	37	37	37	37	37	37	37	37	37	37	37	37	37	37	37	37	37	37	37	37	37	37	29	25	25	25	25	25	29	37	37	37	37	37	37	37	37	37	37	37	37	37	37	37	37	37	37	37	37	1	1	1
1	1	1	37	37	37	37	37	37	37	37	37	37	37	37	37	37	37	37	37	37	37	37	37	37	37	37	37	29	25	25	25	25	25	29	37	37	37	37	37	37	37	37	37	37	37	37	37	37	37	37	37	37	37	37	1	1	1
1	1	1	37	37	37	37	37	37	37	37	37	37	37	37	37	37	37	37	37	37	37	37	37	37	37	37	37	29	25	25	25	25	25	29	37	37	37	37	37	37	37	37	37	37	37	37	37	37	37	37	37	37	37	37	1	1	1
1	1	1	37	37	37	37	37	37	37	37	37	37	37	37	37	37	37	37	37	37	37	37	37	37	37	37	37	29	25	25	25	25	25	29	37	37	37	37	37	37	37	37	37	37	37	37	37	37	37	37	37	37	37	37	1	1	1
1	1	1	37	37	37	37	37	37	37	37	37	37	37	37	37	37	37	37	37	37	37	37	37	37	37	37	37	29	25	25	25	25	25	29	37	37	37	37	37	37	37	37	37	37	37	37	37	37	37	37	37	37	37	37	1	1	1
1	1	1	37	37	37	37	37	37	37	37	37	37	37	37	37	37	37	37	37	37	37	37	37	37	37	37	37	29	25	25	25	25	25	29	37	37	37	37	37	37	37	37	37	37	37	37	37	37	37	37	37	37	37	37	1	1	1
1	1	1	37	37	37	37	37	37	37	37	37	37	37	37	37	37	37	37	37	37	37	37	37	37	37	37	37	29	25	25	25	25	25	29	37	37	37	37	37	37	37	37	37	37	37	37	37	37	37	37	37	37	37	37	1	1	1
1	1	1	37	37	37	37	37	37	37	37	37	37	37	37	37	37	37	37	37	37	37	37	37	37	37	37	37	29	25	25	25	25	25	29	37	37	37	37	37	37	37	37	37	37	37	37	37	37	37	37	37	37	37	37	1	1	1
1	1	1	37	37	37	37	37	37	37	37	37	37	37	37	37	37	37	37	37	37	37	37	37	37	37	37	37	29	25	25	25	25	25	29	37	37	37	37	37	37	37	37	37	37	37	37	37	37	37	37	37	37	37	37	1	1	1
1	1	1	37	37	37	37	37	37	37	37	37	37	37	37	37	37	37	37	37	37	37	37	37	37	37	37	37	29	25	25	25	25	25	29	37	37	37	37	37	37	37	37	37	37	37	37	37	37	37	37	37	37	37	37	1	1	1
1	1	1	37	37	37	37	37	37	37	37	37	37	37	37	37	37	37	37	37	37	37	37	37	37	37	37	37	29	25	25	25	25	25	29	37	37	37	37	37	37	37	37	37	37	37	37	37	37	37	37	37	37	37	37	1	1	1
1	1	1	37	37	37	37	37	37	37	37	37	37	37	37	37	37	37	37	37	37	37	37	37	37	37	37	37	29	25	25	25	25	25	29	37	37	37	37	37	37	37	37	37	37	37	37	37	37	37	37	37	37	37	37	1	1	1
1	1	1	37	37	37	37	37	37	37	37	37	37	37	37	37	37	37	37	37	37	37	37	37	37	37	37	37	29	25	25	25	25	25	29	37	37	37	37	37	37	37	37	37	37	37	37	37	37	37	37	37	37	37	37	1	1	1
1	1	1	37	37	37	37	37	37	37	37	37	37	37	37	37	37	37	37	37	37	37	37	37	37	37	37	37	29	25	25	25	25	25	29	37	37	37	37	37	37	37	37	37	37	37	37	37	37	37	37	37	37	37	37	1	1	1
1	1	1	37	37	37	37	37	37	37	37	37	37	37	37	37	37	37	37	37	37	37	37	37	37	37	37	37	29	25	25	25	25	25	29	37	37	37	37	37	37	37	37	37	37	37	37	37	37	37	37	37	37	37	37	1	1	1
1	1	1	37	37	37	37	37	37	37	37	37	37	37	37	37	37	37	37	37	37	37	37	37	37	37	37	37	29	25	25	25	25	25	29	37	37	37	37	37	37	37	37	37	37	37	37	37	37	37	37	37	37	37	37	1	1	1
1	1	1	37	37	37	37	37	37	37	37	37	37	37	37	37	37	37	37	37	37	37	37	37	37	37	37	37	29	25	25	25	25	25	29	37	37	37	37	37	37	37	37	37	37	37	37	37	37	37	37	37	37	37	37	1	1	1
1	1	1	37	37	37	37	37	37	37	37	37	37	37	37	37	37	37	37	37	37	37	37	37	37	37	37	37	29	25	25	25	25	25	29	37	37	37	37	37	37	37	37	37	37	37	37	37	37	37	37	37	37	37	37	1	1	1
1	1	1	37	37	37	37	37	37	37	37	37	37	37	37	37	37	37	37	37	37	37	37	37	37	37	37	37	29	25	25	25	25	25	29	37	37	37	37	37	37	37	37	37	37	37	37	37	37	37	37	37	37	37	37	1	1	1
1	1	1	37	37	37	37	37	37	37	37	37	37	37	37	37	37	37	37	37	37	37	37	37	37	37	37	37	30	30	30	25	30	30	30	37	37	37	37	37	37	37	37	37	37	37	37	37	37	37	37	37	37	37	37	1	1	1
1	1	1	37	37	37	37	37	37	37	37	37	37	37	37	37	37	37	37	37	37	37	37	37	37	37	37	37	30	30	30	30	30	30	30	37	37	37	37	37	37	37	37	37	37	37	37	37	37	37	37	37	37	37	37	1	1	1
1	1	1	37	37	37	37	37	37	37	37	37	37	37	37	37	37	37	37	37	37	37	37	37	37	37	37	37	30	30	30	30	30	30	30	37	37	37	37	37	37	37	37	37	37	37	37	37	37	37	37	37	37	37	37	1	1	1
1	1	1	37	37	37	37	37	37	37	37	37	37	37	37	37	37	37	37	37	37	37	37	37	37	37	37	37	30	30	30	30	30	30	30	37	37	37	37	37	37	37	37	37	37	37	37	37	37	37	37	37	37	37	37	1	1	1
1	1	1	37	37	37	37	37	37	37	37	37	37	37	37	37	37	37	37	37	37	37	37	37	37	37	37	37	30	30	30	30	30	30	30	37	37	37	37	37	37	37	37	37	37	37	37	37	37	37	37	37	37	37	37	1	1	1
1	1	1	37	37	37	37	37	37	37	37	37	37	37	37	37	37	37	37	37	37	37	37	30	30	30	30	30	30	30	30	30	30	30	30	30	30	30	30	30	37	37	37	37	37	37	37	37	37	37	37	37	37	37	37	1	1	1
1	1	1	37	37	37	37	37	37	37	37	37	37	37	37	37	37	37	37	37	37	37	37	30	30	30	30	30	30	30	30	30	30	30	30	30	30	30	30	30	37	37	37	37	37	37	37	37	37	37	37	37	37	37	37	1	1	1
1	1	1	37	37	37	37	37	37	37	37	37	37	37	37	37	37	37	37	37	37	37	37	30	30	30	30	30	30	30	30	30	30	30	30	30	30	30	30	30	37	37	37	37	37	37	37	37	37	37	37	37	37	37	37	1	1	1
1	1	1	37	37	37	37	37	37	37	37	37	37	37	37	37	37	37	37	37	37	37	37	30	30	30	30	30	30	30	30	30	30	30	30	30	30	30	30	30	37	37	37	37	37	37	37	37	37	37	37	37	37	37	37	1	1	1
1	1	1	37	37	37	37	37	37	37	37	37	37	37	37	37	37	37	37	37	37	37	37	30	30	30	30	30	30	30	30	30	30	30	30	30	30	30	30	30	37	37	37	37	37	37	37	37	37	37	37	37	37	37	37	1	1	1
1	1	1	37	37	37	37	37	37	37	37	37	37	37	37	37	37	37	37	37	37	37	37	30	30	30	30	30	30	30	30	30	30	30	30	30	30	30	30	30	37	37	37	37	37	37	37	37	37	37	37	37	37	37	37	1	1	1
1	1	1	1	1	1	1	1	1	1	1	1	1	1	1	1	1	1	1	1	1	1	1	1	1	1	1	1	1	1	1	1	1	1	1	1	1	1	1	1	1	1	1	1	1	1	1	1	1	1	1	1	1	1	1	1	1	1
1	1	1	1	1	1	1	1	1	1	1	1	1	1	1	1	1	1	1	1	1	1	1	1	1	1	1	1	1	1	1	1	1	1	1	1	1	1	1	1	1	1	1	1	1	1	1	1	1	1	1	1	1	1	1	1	1	1
1	1	1	1	1	1	1	1	1	1	1	1	1	1	1	1	1	1	1	1	1	1	1	1	1	1	1	1	1	1	1	1	1	1	1	1	1	1	1	1	1	1	1	1	1	1	1	1	1	1	1	1	1	1	1	1	1	1
407 31 60
408 40 21
408 40 22
408 40 23
408 40 24
62 896 1280
62 896 1376
62 896 1472
62 896 1568
62 896 1664
62 896 1760
62 896 1856
67 896 1112
65 1088 1088
65 1184 1088
67 1248 1112
65 832 1088
65 736 1088
65 640 1088
67 448 1112
62 448 1024
62 448 928
62 448 832
62 448 736
62 448 640
62 448 544
67 448 376
65 640 352
65 736 352
65 832 352
67 896 376
62 896 544
67 896 632
65 1088 608
65 1184 608
5