45 45
14 27
10
9
0 0
1	1	1	1	1	1	1	1	1	1	1	1	1	1	1	1	1	1	1	1	1	1	1	1	1	1	1	1	1	1	1	1	1	1	1	1	1	1	1	1	1	1	1	1	1
1	1	1	1	1	1	1	1	1	1	1	1	1	1	1	1	1	1	1	1	1	1	1	1	1	1	1	1	1	1	1	1	1	1	1	1	1	1	1	1	1	1	1	1	1
1	1	1	1	1	1	1	1	1	1	1	1	1	1	1	1	1	1	1	1	1	1	1	1	1	1	1	1	1	1	1	1	1	1	1	1	1	1	1	1	1	1	1	1	1
1	1	1	29	29	29	29	29	29	29	29	29	29	29	29	29	29	29	29	29	29	29	29	29	29	29	29	29	29	29	29	29	29	29	29	29	29	29	29	29	29	29	1	1	1
1	1	1	29	29	29	29	29	29	29	29	29	29	29	29	29	29	29	29	29	29	29	29	29	29	29	29	29	29	29	29	29	29	29	29	29	29	29	29	29	29	29	1	1	1
1	1	1	29	29	29	29	29	29	29	29	29	29	29	29	29	29	29	29	29	29	29	29	29	29	29	29	29	29	29	29	29	29	29	29	29	29	29	29	29	29	29	1	1	1
1	1	1	29	29	29	29	29	29	29	29	29	29	29	29	29	29	29	29	29	29	29	29	29	29	29	29	29	29	29	29	29	29	29	29	29	29	29	29	29	29	29	1	1	1
1	1	1	29	29	29	29	29	29	29	29	29	29	29	29	29	29	29	29	29	29	29	29	29	29	29	29	29	29	29	29	29	29	29	29	29	29	29	29	29	29	29	1	1	1
1	1	1	29	29	29	29	29	29	29	29	29	29	29	29	29	29	29	29	29	29	29	29	29	29	29	29	29	29	29	29	29	29	29	29	29	29	29	29	29	29	29	1	1	1
1	1	1	29	29	29	29	29	29	29	29	29	29	29	29	29	29	29	29	29	29	29	29	29	29	29	29	29	29	29	29	29	29	29	29	29	29	29	29	29	29	29	1	1	1
1	1	1	29	29	29	29	29	29	29	29	29	29	29	34	34	34	34	34	34	34	34	34	34	34	34	34	34	34	34	34	29	29	29	29	29	29	29	29	29	29	29	1	1	1
1	1	1	29	29	29	29	29	29	29	29	29	29	29	34	35	35	35	35	35	35	35	35	35	35	35	35	35	35	35	34	29	29	29	29	29	29	29	29	29	29	29	1	1	1
1	1	1	29	29	29	29	29	29	29	29	29	29	29	34	35	35	35	35	35	35	35	35	35	35	35	35	35	35	35	34	29	29	29	29	29	29	29	29	29	29	29	1	1	1
1	1	1	29	29	29	29	29	29	29	29	29	29	29	34	35	35	35	35	35	35	35	35	35	35	35	35	35	35	35	34	29	29	29	29	29	29	29	29	29	29	29	1	1	1
1	1	1	29	29	29	29	29	29	29	29	29	29	29	34	26	26	26	26	26	26	26	26	26	26	26	26	26	26	26	35	29	29	29	29	29	29	29	29	29	29	29	1	1	1
1	1	1	25	25	25	25	25	29	29	29	29	29	29	34	26	26	26	26	26	26	26	26	26	26	26	26	26	26	26	35	29	29	29	29	29	29	29	29	29	29	29	1	1	1
1	1	1	25	25	25	25	25	29	29	29	29	29	29	34	26	26	26	26	26	26	26	26	26	26	26	26	26	26	26	35	29	29	29	29	29	29	29	29	29	29	29	1	1	1
1	1	1	25	25	25	25	25	29	29	29	29	29	29	34	26	26	26	26	26	26	26	26	26	26	26	26	26	26	26	26	25	25	25	25	25	25	25	25	25	25	25	1	1	1	
1	1	1	25	25	25	25	25	29	29	29	29	29	29	34	26	26	26	26	26	26	26	26	26	26	26	26	26	26	26	26	25	25	25	25	25	25	25	25	25	25	25	1	1	1	
1	1	1	25	25	25	25	25	29	29	29	29	29	29	34	26	26	26	26	26	34	34	34	34	34	26	26	26	26	26	26	25	25	25	25	25	25	25	25	25	25	25	1	1	1
1	1	1	25	25	25	25	25	29	29	29	29	29	29	34	26	26	26	26	26	34	34	34	34	34	26	26	26	26	26	26	25	25	25	25	25	25	25	25	25	25	25	1	1	1
1	1	1	25	25	25	25	25	29	29	29	29	29	29	34	26	26	26	26	26	34	34	34	34	34	26	26	26	26	26	26	25	25	25	25	25	25	25	25	25	25	25	1	1	1
1	1	1	25	25	25	25	25	29	29	29	29	29	29	35	26	26	26	26	26	34	34	34	34	34	26	26	26	26	26	34	29	29	29	29	29	29	29	29	29	29	29	1	1	1
1	1	1	25	25	25	25	25	29	29	29	29	29	29	35	26	26	26	26	26	34	34	34	34	34	26	26	26	26	26	34	29	29	29	29	29	29	29	29	29	29	29	1	1	1
1	1	1	25	25	25	25	25	29	29	29	29	29	29	35	26	26	26	26	26	35	35	35	35	35	26	26	26	26	26	34	29	29	29	29	29	29	29	29	29	29	29	1	1	1
1	1	1	25	25	25	25	25	25	25	25	25	25	25	26	26	26	26	26	26	35	35	0	35	35	26	26	26	26	26	34	29	29	29	29	29	29	29	29	29	29	29	1	1	1
1	1	1	25	25	25	25	25	25	25	25	25	25	25	26	26	26	26	26	26	26	26	26	26	26	26	26	26	26	26	34	29	29	29	29	29	29	29	29	29	29	29	1	1	1
1	1	1	25	25	25	25	25	25	25	25	25	25	25	26	26	26	26	26	26	26	26	26	26	26	26	26	26	26	26	34	29	29	29	29	29	29	29	29	29	29	29	1	1	1
1	1	1	25	25	25	25	25	25	25	25	25	25	25	26	26	26	26	26	26	26	26	26	26	26	26	26	26	26	26	34	29	29	29	29	29	29	29	29	29	29	29	1	1	1
1	1	1	25	25	25	25	25	25	25	25	25	25	25	26	26	26	26	26	26	26	26	26	26	26	26	26	26	26	26	34	29	29	29	29	29	29	29	29	29	29	29	1	1	1
1	1	1	29	29	29	29	29	29	29	29	29	29	29	34	26	26	26	26	26	26	26	26	26	26	26	26	26	26	26	34	29	29	29	29	29	29	29	29	29	29	29	1	1	1
1	1	1	29	29	29	29	29	29	29	29	29	29	29	34	26	26	26	26	26	26	26	26	26	26	26	26	26	26	26	34	29	29	29	29	29	29	29	29	29	29	29	1	1	1
1	1	1	29	29	29	29	29	29	29	29	29	29	29	34	26	26	26	26	26	26	26	26	26	26	26	26	26	26	26	34	29	29	29	29	29	29	29	29	29	29	29	1	1	1
1	1	1	29	29	29	29	29	29	29	29	29	29	29	34	34	34	34	34	34	34	34	34	34	34	34	34	34	34	34	34	29	29	29	29	29	29	29	29	29	29	29	1	1	1
1	1	1	29	29	29	29	29	29	29	29	29	29	29	29	29	29	29	29	29	29	29	29	29	29	29	29	29	29	29	29	29	29	29	29	29	29	29	29	29	29	29	1	1	1
1	1	1	29	29	29	29	29	29	29	29	29	29	29	29	29	29	29	29	29	29	29	29	29	29	29	29	29	29	29	29	29	29	29	29	29	29	29	29	29	29	29	1	1	1
1	1	1	29	29	29	29	29	29	29	29	29	29	29	29	29	29	29	29	29	29	29	29	29	29	29	29	29	29	29	29	29	29	29	29	29	29	29	29	29	29	29	1	1	1
1	1	1	29	29	29	29	29	29	29	29	29	29	29	29	29	29	29	29	29	29	29	29	29	29	29	29	29	29	29	29	29	29	29	29	29	29	29	29	29	29	29	1	1	1
1	1	1	29	29	29	29	29	29	29	29	29	29	29	29	29	29	29	29	29	29	29	29	29	29	29	29	29	29	29	29	29	29	29	29	29	29	29	29	29	29	29	1	1	1
1	1	1	29	29	29	29	29	29	29	29	29	29	29	29	29	29	29	29	29	29	29	29	29	29	29	29	29	29	29	29	29	29	29	29	29	29	29	29	29	29	29	1	1	1
1	1	1	29	29	29	29	29	29	29	29	29	29	29	29	29	29	29	29	29	29	29	29	29	29	29	29	29	29	29	29	29	29	29	29	29	29	29	29	29	29	29	1	1	1
1	1	1	29	29	29	29	29	29	29	29	29	29	29	29	29	29	29	29	29	29	29	29	29	29	29	29	29	29	29	29	29	29	29	29	29	29	29	29	29	29	29	1	1	1
1	1	1	1	1	1	1	1	1	1	1	1	1	1	1	1	1	1	1	1	1	1	1	1	1	1	1	1	1	1	1	1	1	1	1	1	1	1	1	1	1	1	1	1	1
1	1	1	1	1	1	1	1	1	1	1	1	1	1	1	1	1	1	1	1	1	1	1	1	1	1	1	1	1	1	1	1	1	1	1	1	1	1	1	1	1	1	1	1	1
1	1	1	1	1	1	1	1	1	1	1	1	1	1	1	1	1	1	1	1	1	1	1	1	1	1	1	1	1	1	1	1	1	1	1	1	1	1	1	1	1	1	1	1	1
409 13 26
409 13 27
409 13 28
409 13 29
101 31 17
410 31 18
410 31 19
410 31 20
410 31 21
411 18 13
67 64 536
62 64 704
67 64 792
65 256 768
65 352 768
65 992 512
65 1088 512
65 1184 512
65 1280 512
6