17 21
5 16
4
0
0 0
1	1	1	1	1	1	1	1	1	1	1	1	1	1	1	1	1
1	1	1	1	1	1	1	1	1	1	1	1	1	1	1	1	1
1	1	1	1	1	1	1	1	1	1	1	1	1	1	1	1	1
1	1	1	34	34	34	34	34	34	34	34	34	34	34	1	1	1
1	1	1	34	35	35	35	35	35	35	35	35	35	34	1	1	1
1	1	1	34	35	35	35	35	35	35	35	35	35	34	1	1	1
1	1	1	34	35	35	35	35	35	35	35	35	35	34	1	1	1
1	1	1	34	26	26	26	26	26	26	26	26	26	34	1	1	1
1	1	1	34	26	26	26	26	26	26	26	26	26	34	1	1	1
1	1	1	34	26	26	26	26	26	26	26	26	26	34	1	1	1
1	1	1	34	26	26	26	26	26	26	26	26	26	34	1	1	1
1	1	1	34	26	26	26	26	26	26	26	26	26	34	1	1	1
1	1	1	34	26	26	26	26	26	26	26	26	26	34	1	1	1
1	1	1	34	26	26	26	26	26	26	26	26	26	34	1	1	1
1	1	1	34	26	26	26	26	26	26	26	26	26	34	1	1	1
1	1	1	34	26	26	26	26	26	26	26	26	26	34	1	1	1
1	1	1	34	34	26	34	34	34	34	34	26	34	34	1	1	1
1	1	1	1	1	0	1	1	1	1	1	0	1	1	1	1	1
1	1	1	1	1	1	1	1	1	1	1	1	1	1	1	1	1
1	1	1	1	1	1	1	1	1	1	1	1	1	1	1	1	1
1	1	1	1	1	1	1	1	1	1	1	1	1	1	1	1	1
416 5 17
417 11 17
701 6 15
705 5 7
6